{
  "puzzle_info": {
    "grid_width": 4,
    "grid_height": 4,
    "steps_to_solve": 10
  },
  "solution_path": [
    "0020100000000002",
    "0002100000000002",
    "0000100000020002",
    "0000100000022000",
    "0000100020020000",
    "0000100000220000",
    "0000100000200002",
    "0000100000202000",
    "0000100020200000",
    "0000100002200000",
    "0000100002020000"
  ]
}
