{
  "puzzle_info": {
    "grid_width": 4,
    "grid_height": 4,
    "steps_to_solve": 12
  },
  "solution_path": [
    "0300000000000034",
    "0304000000000030",
    "0340000000000030",
    "0300000000400030",
    "0300000000400003",
    "0303000000400000",
    "0033000000400000",
    "0003003000400000",
    "3000003000400000",
    "3000003040000000",
    "0000303040000000",
    "0000033040000000",
    "0000030340000000"
  ]
}
