{
  "puzzle_info": {
    "grid_width": 4,
    "grid_height": 4,
    "steps_to_solve": 11
  },
  "solution_path": [
    "0000203000000003",
    "0000003000002003",
    "0000000300002003",
    "0000000300032000",
    "0000000330002000",
    "0000000330000002",
    "0000000330020000",
    "0000000332000000",
    "0000000302003000",
    "0000000302000003",
    "0000000302030000",
    "0003000002030000"
  ]
}
