{
  "puzzle_info": {
    "grid_width": 4,
    "grid_height": 4,
    "steps_to_solve": 13
  },
  "solution_path": [
    "0000000000403203",
    "3000000000400203",
    "3000000000400023",
    "3003000000400020",
    "0033000000400020",
    "0003003000400020",
    "3000003000400020",
    "3000003040000020",
    "3000403000000020",
    "3000043000000020",
    "0000043000003020",
    "0000043000000320",
    "0000043003000020",
    "0000403003000020"
  ]
}
