{
  "puzzle_info": {
    "grid_width": 4,
    "grid_height": 4,
    "steps_to_solve": 10
  },
  "solution_path": [
    "0000000440000040",
    "0000000440000004",
    "0000000040040004",
    "0000000044000004",
    "0000000004004004",
    "0000000004000044",
    "0040000004000004",
    "0040000004004000",
    "4040000004000000",
    "0440000004000000",
    "0400000004000040"
  ]
}
