{
  "puzzle_info": {
    "grid_width": 4,
    "grid_height": 4,
    "steps_to_solve": 12
  },
  "solution_path": [
    "3000030001000020",
    "0000030001003020",
    "0000000301003020",
    "0000000001003023",
    "0000000001003203",
    "3000000001000203",
    "0003000001000203",
    "0000000001030203",
    "0000000001030230",
    "0030000001030200",
    "0030000001300200",
    "0000003001300200",
    "0000003001030200"
  ]
}
