{
  "puzzle_info": {
    "grid_width": 5,
    "grid_height": 5,
    "steps_to_solve": 13
  },
  "solution_path": [
    "0000000000000021200000000",
    "0200000000000021000000000",
    "2000000000000021000000000",
    "0000000000200021000000000",
    "0000000000000221000000000",
    "0000200000000201000000000",
    "2000000000000201000000000",
    "0000000000200201000000000",
    "0000000000002201000000000",
    "0002000000002001000000000",
    "2000000000002001000000000",
    "0000000000202001000000000",
    "0000000000022001000000000",
    "0000000000002001000002000"
  ]
}
