{
  "puzzle_info": {
    "grid_width": 4,
    "grid_height": 4,
    "steps_to_solve": 13
  },
  "solution_path": [
    "0220004000000000",
    "0020004000000200",
    "0002004000000200",
    "0000004000000202",
    "0000004000000022",
    "0000000000400022",
    "0002000000400020",
    "0002000000400002",
    "0002000200400000",
    "2000000200400000",
    "0000000200402000",
    "0000200000402000",
    "0000200020400000",
    "0000000220400000"
  ]
}
