{
  "puzzle_info": {
    "grid_width": 4,
    "grid_height": 4,
    "steps_to_solve": 13
  },
  "solution_path": [
    "0000004400030000",
    "0040000400030000",
    "4000000400030000",
    "4000000430000000",
    "4000300400000000",
    "4000003400000000",
    "0000003400004000",
    "0000003000004004",
    "0000003000000044",
    "0000003000400004",
    "0000300000400004",
    "0000300000404000",
    "0000300040400000",
    "0000300004400000"
  ]
}
