{
  "puzzle_info": {
    "grid_width": 4,
    "grid_height": 4,
    "steps_to_solve": 13
  },
  "solution_path": [
    "0400023000000004",
    "0004023000000004",
    "0004003000000204",
    "0004003000000024",
    "0004003000200004",
    "0004300000200004",
    "0004300400200000",
    "0004340000200000",
    "0000340000200004",
    "3000040000200004",
    "0003040000200004",
    "0003040400200000",
    "3000040400200000",
    "0000040400203000"
  ]
}
