{
  "puzzle_info": {
    "grid_width": 4,
    "grid_height": 4,
    "steps_to_solve": 13
  },
  "solution_path": [
    "0420010003000000",
    "4020010003000000",
    "4000010003000020",
    "4000010030000020",
    "4000310000000020",
    "0004310000000020",
    "0000310000000024",
    "0000310000002004",
    "0000310000002400",
    "0000310020000400",
    "0000310000020400",
    "0000310004020000",
    "0000310004200000",
    "0000310000200400"
  ]
}
