{
  "puzzle_info": {
    "grid_width": 5,
    "grid_height": 5,
    "steps_to_solve": 18
  },
  "solution_path": [
    "0030004100000000000202000",
    "3000004100000000000202000",
    "3400000100000000000202000",
    "3400200100000000000002000",
    "3420000100000000000002000",
    "3420000100000000000000002",
    "3020000100000000000004002",
    "0320000100000000000004002",
    "0020000100000000300004002",
    "0020000100000000300000042",
    "0020200100000000300000040",
    "0022000100000000300000040",
    "0020000100000000302000040",
    "0020000100000000302000004",
    "0020400100000000302000000",
    "0024000100000000302000000",
    "0020000100000400302000000",
    "0020000100000400320000000",
    "0020000100000403020000000"
  ]
}
