{
  "puzzle_info": {
    "grid_width": 4,
    "grid_height": 4,
    "steps_to_solve": 14
  },
  "solution_path": [
    "0000000400130302",
    "0000400000130302",
    "0300400000130002",
    "0300400000132000",
    "0000400000132300",
    "0000000040132300",
    "0000000040102303",
    "0000000040102330",
    "0300000040102030",
    "0300000004102030",
    "0000030004102030",
    "0000030040102030",
    "0000030040100230",
    "0000030042100030",
    "0300000042100030"
  ]
}
