{
  "puzzle_info": {
    "grid_width": 4,
    "grid_height": 4,
    "steps_to_solve": 12
  },
  "solution_path": [
    "1000000204000000",
    "1000000004000002",
    "1000000040000002",
    "1000400000000002",
    "1000000400000002",
    "1000000400002000",
    "1000200400000000",
    "1000002400000000",
    "1000002000000004",
    "1000002000004000",
    "1000402000000000",
    "1000042000000000",
    "1000040000000020"
  ]
}
