{
  "puzzle_info": {
    "grid_width": 4,
    "grid_height": 4,
    "steps_to_solve": 12
  },
  "solution_path": [
    "0330003000002000",
    "0330000000002030",
    "0300000000302030",
    "0003000000302030",
    "2003000000300030",
    "0023000000300030",
    "0003002000300030",
    "3000002000300030",
    "3000002030000030",
    "0000302030000030",
    "0000302030300000",
    "0000302003300000",
    "0000302003030000"
  ]
}
