{
  "puzzle_info": {
    "grid_width": 4,
    "grid_height": 4,
    "steps_to_solve": 12
  },
  "solution_path": [
    "0000200040000010",
    "2000000040000010",
    "0002000040000010",
    "4002000000000010",
    "4200000000000010",
    "0200000000004010",
    "0200000000000410",
    "0200040000000010",
    "2000040000000010",
    "0000040000002010",
    "0000040000000210",
    "0000040002000010",
    "0000040000020010"
  ]
}
