{
  "puzzle_info": {
    "grid_width": 4,
    "grid_height": 4,
    "steps_to_solve": 12
  },
  "solution_path": [
    "4042000004000000",
    "0042000004004000",
    "0040000004004002",
    "0040000004004200",
    "4040000004000200",
    "0440000004000200",
    "0040040004000200",
    "0004040004000200",
    "0004040000040200",
    "0000040400040200",
    "0000040402040000",
    "0000040402400000",
    "0000040420400000"
  ]
}
