{
  "puzzle_info": {
    "grid_width": 5,
    "grid_height": 5,
    "steps_to_solve": 19
  },
  "solution_path": [
    "0002000002000000300200001",
    "2000000002000000300200001",
    "2000000002000003000200001",
    "2000000002000003200000001",
    "2000030002000000200000001",
    "0000230002000000200000001",
    "0000232000000000200000001",
    "0000032000000000200200001",
    "3000002000000000200200001",
    "0000302000000000200200001",
    "0000302002000000200000001",
    "0000302200000000200000001",
    "0000002200000000200300001",
    "0000002200000000230000001",
    "0000002200020000030000001",
    "0200000200020000030000001",
    "0000200200020000030000001",
    "0000000200020000030200001",
    "0000000200020000032000001",
    "0000000200020003002000001"
  ]
}
