{
  "puzzle_info": {
    "grid_width": 4,
    "grid_height": 4,
    "steps_to_solve": 12
  },
  "solution_path": [
    "0033004000030000",
    "0030004300030000",
    "0030400300030000",
    "0000400300030030",
    "0000430000030030",
    "0000030000034030",
    "0000030000030430",
    "0000030004030030",
    "0030030004030000",
    "0003030004030000",
    "0000030304030000",
    "0000030304300000",
    "0000030300300400"
  ]
}
