{
  "puzzle_info": {
    "grid_width": 4,
    "grid_height": 4,
    "steps_to_solve": 13
  },
  "solution_path": [
    "0302000020000000",
    "0002000020000300",
    "2000000020000300",
    "2000200000000300",
    "2000200000003000",
    "2000200030000000",
    "2000000230000000",
    "0000200230000000",
    "0000002230000000",
    "0002002030000000",
    "2000002030000000",
    "0000202030000000",
    "0000022030000000",
    "0200002030000000"
  ]
}
