{
  "puzzle_info": {
    "grid_width": 4,
    "grid_height": 4,
    "steps_to_solve": 13
  },
  "solution_path": [
    "0200000400000003",
    "0002000400000003",
    "0002400000000003",
    "0002000000004003",
    "0002000000004300",
    "4002000000000300",
    "0042000000000300",
    "0040000000000302",
    "0040000000000320",
    "0040002000000300",
    "0004002000000300",
    "0000002000000304",
    "0000002000000340",
    "0000002000400300"
  ]
}
