{
  "puzzle_info": {
    "grid_width": 4,
    "grid_height": 4,
    "steps_to_solve": 11
  },
  "solution_path": [
    "0000000010000042",
    "0002000010000040",
    "0002000010000004",
    "0002000410000000",
    "2000000410000000",
    "0000200410000000",
    "0000002410000000",
    "0004002010000000",
    "4000002010000000",
    "0000402010000000",
    "0000042010000000",
    "0000040210000000"
  ]
}
