{
  "puzzle_info": {
    "grid_width": 4,
    "grid_height": 4,
    "steps_to_solve": 12
  },
  "solution_path": [
    "0012000000000003",
    "0010000000020003",
    "0010000020000003",
    "0010000000002003",
    "0010000000002300",
    "2010000000000300",
    "0210000000000300",
    "0010000002000300",
    "0010000002003000",
    "3010000002000000",
    "0310000002000000",
    "0010030002000000",
    "0010030000020000"
  ]
}
