{
  "puzzle_info": {
    "grid_width": 4,
    "grid_height": 4,
    "steps_to_solve": 15
  },
  "solution_path": [
    "3000013400100200",
    "3030010400100200",
    "3300010400100200",
    "3300010000100204",
    "3300010002100004",
    "3300010020100004",
    "0300310020100004",
    "0300310002100004",
    "0300310002104000",
    "0300310000104200",
    "0300310000104002",
    "0300310000100042",
    "0302310000100040",
    "0320310000100040",
    "0300312000100040",
    "0300310200100040"
  ]
}
