{
  "puzzle_info": {
    "grid_width": 5,
    "grid_height": 5,
    "steps_to_solve": 22
  },
  "solution_path": [
    "0420020000000000000010000",
    "0020020000000000000014000",
    "2000020000000000000014000",
    "2000000000000002000014000",
    "2000000000000000000214000",
    "0000000000000002000214000",
    "0000000000000000002214000",
    "0000200000000000002014000",
    "0400200000000000002010000",
    "0420000000000000002010000",
    "4020000000000000002010000",
    "0020000000000004002010000",
    "0020000000000000042010000",
    "0020000400000000002010000",
    "2000000400000000002010000",
    "0000000400000002002010000",
    "0000000400000000022010000",
    "0002000400000000020010000",
    "2000000400000000020010000",
    "0000000400000002020010000",
    "0000000400000000220010000",
    "0000000400002000200010000",
    "0040000000002000200010000"
  ]
}
