{
  "puzzle_info": {
    "grid_width": 4,
    "grid_height": 4,
    "steps_to_solve": 13
  },
  "solution_path": [
    "2000030000001430",
    "0000030020001430",
    "0000000320001430",
    "0000000320001403",
    "0000000320001043",
    "0040000320001003",
    "0040000320031000",
    "0040300020031000",
    "0040300000231000",
    "0000304000231000",
    "0000004030231000",
    "0000004003231000",
    "0000004003031020",
    "0000004003301020"
  ]
}
