{
  "puzzle_info": {
    "grid_width": 4,
    "grid_height": 4,
    "steps_to_solve": 13
  },
  "solution_path": [
    "2041031000000000",
    "0241031000000000",
    "0241001000000300",
    "0241001000000003",
    "0041001000000203",
    "4001001000000203",
    "4001001000000230",
    "4001001000002030",
    "4001201000000030",
    "4001021000000030",
    "0001021000004030",
    "0001021000000430",
    "0001021004000030",
    "0001201004000030"
  ]
}
