{
  "puzzle_info": {
    "grid_width": 5,
    "grid_height": 5,
    "steps_to_solve": 18
  },
  "solution_path": [
    "0030401300300000000010000",
    "3000401300300000000010000",
    "3030401000300000000010000",
    "3034001000300000000010000",
    "3034001000000003000010000",
    "3034001000000000000310000",
    "0034001000000003000310000",
    "0034001000000000003310000",
    "0030001000000400003310000",
    "0030301000000400003010000",
    "0003301000000400003010000",
    "0000301030000400003010000",
    "3000001030000400003010000",
    "3000001030400000003010000",
    "0000031030400000003010000",
    "0000031030000004003010000",
    "0000031030000000043010000",
    "0000031030000300040010000",
    "0000031300000300040010000"
  ]
}
