{
  "puzzle_info": {
    "grid_width": 5,
    "grid_height": 5,
    "steps_to_solve": 10
  },
  "solution_path": [
    "4000010000001000000000004",
    "0000410000001000000000004",
    "0000410004001000000000000",
    "0000414000001000000000000",
    "0400410000001000000000000",
    "0440010000001000000000000",
    "0040010000001000000004000",
    "0000010400001000000004000",
    "0000010400001000000040000",
    "0000010400401000000000000",
    "0000010400041000000000000"
  ]
}
