{
  "puzzle_info": {
    "grid_width": 4,
    "grid_height": 4,
    "steps_to_solve": 12
  },
  "solution_path": [
    "0000000300003200",
    "3000000300000200",
    "3000000300002000",
    "3000200300000000",
    "3000230000000000",
    "3000030000002000",
    "0000030030002000",
    "0000030000032000",
    "2000030000030000",
    "0002030000030000",
    "0000030200030000",
    "0000032000030000",
    "0000030000030020"
  ]
}
