{
  "puzzle_info": {
    "grid_width": 4,
    "grid_height": 4,
    "steps_to_solve": 13
  },
  "solution_path": [
    "2030040000002000",
    "2000040000002030",
    "2000400000002030",
    "2000400000002300",
    "2000400020000300",
    "2000000420000300",
    "0000200420000300",
    "0000002420000300",
    "0000002020000304",
    "0000002020000340",
    "0300002020000040",
    "0300002020400000",
    "0300002002400000",
    "0300002002000040"
  ]
}
