{
  "puzzle_info": {
    "grid_width": 4,
    "grid_height": 4,
    "steps_to_solve": 10
  },
  "solution_path": [
    "0044000000000001",
    "0040000000040001",
    "0040000040000001",
    "0040000000004001",
    "0040000000000041",
    "0040004000000001",
    "4000004000000001",
    "0000004000004001",
    "0000004000000041",
    "0000004000400001",
    "0000400000400001"
  ]
}
