{
  "puzzle_info": {
    "grid_width": 4,
    "grid_height": 4,
    "steps_to_solve": 12
  },
  "solution_path": [
    "3000100040030100",
    "0003100040030100",
    "0000100340030100",
    "0000100300430100",
    "0000100300030140",
    "0000100330000140",
    "0000100300003140",
    "0000100300003104",
    "0000100300043100",
    "0000130000043100",
    "0000100003043100",
    "0000100003403100",
    "0000100030403100"
  ]
}
