{
  "puzzle_info": {
    "grid_width": 4,
    "grid_height": 4,
    "steps_to_solve": 12
  },
  "solution_path": [
    "0300000000004003",
    "0003000000004003",
    "0003000300004000",
    "3000000300004000",
    "3000300000004000",
    "3000300040000000",
    "3000000340000000",
    "0000300340000000",
    "0000003340000000",
    "0003003040000000",
    "3000003040000000",
    "0000303040000000",
    "0000303000040000"
  ]
}
