{
  "puzzle_info": {
    "grid_width": 5,
    "grid_height": 5,
    "steps_to_solve": 16
  },
  "solution_path": [
    "0020000000000000204000040",
    "0020000000000000004002040",
    "0020000000000000004002400",
    "0000000000000000024002400",
    "0000000000000002004002400",
    "0200000000000002004000400",
    "0000200000000002004000400",
    "0040200000000002004000000",
    "0042000000000002004000000",
    "0040000000000202004000000",
    "0040000000000202400000000",
    "2040000000000200400000000",
    "0240000000000200400000000",
    "0040000000020200400000000",
    "0040000000002200400000000",
    "0000000400002200400000000",
    "0000000400200200400000000"
  ]
}
