{
  "puzzle_info": {
    "grid_width": 4,
    "grid_height": 4,
    "steps_to_solve": 11
  },
  "solution_path": [
    "0000003000000044",
    "0000003000400004",
    "0000300000400004",
    "0000300000404000",
    "0000300040400000",
    "3000000040400000",
    "3000000004400000",
    "3040000004000000",
    "0340000004000000",
    "0040030004000000",
    "0000030004000040",
    "0000030000040040"
  ]
}
