{
  "puzzle_info": {
    "grid_width": 4,
    "grid_height": 4,
    "steps_to_solve": 12
  },
  "solution_path": [
    "4000000000012000",
    "0004000000012000",
    "0000000400012000",
    "2000000400010000",
    "0002000400010000",
    "0002400000010000",
    "0000400200010000",
    "0000420000010000",
    "4000020000010000",
    "0004020000010000",
    "0000020400010000",
    "0000024000010000",
    "0000020000010040"
  ]
}
