{
  "puzzle_info": {
    "grid_width": 4,
    "grid_height": 4,
    "steps_to_solve": 13
  },
  "solution_path": [
    "0000002000034000",
    "0000200000034000",
    "0000200040030000",
    "2000000040030000",
    "0002000040030000",
    "0002000000430000",
    "0002000300400000",
    "2000000300400000",
    "0000000300402000",
    "0000300000402000",
    "0000300020400000",
    "0000000320400000",
    "0000000302400000",
    "0200000300400000"
  ]
}
