{
  "puzzle_info": {
    "grid_width": 5,
    "grid_height": 5,
    "steps_to_solve": 20
  },
  "solution_path": [
    "0000000000003003400000001",
    "0400000000003003000000001",
    "4000000000003003000000001",
    "0000000000403003000000001",
    "0000000000043003000000001",
    "0000000000040003000000301",
    "0000000000040000000030301",
    "0000000000040000000030031",
    "0003000000040000000030001",
    "0003000000040000000000031",
    "0003000030040000000000001",
    "3000000030040000000000001",
    "0000000030040000000030001",
    "0000000030040000000000031",
    "0000000030040300000000001",
    "0000030000040300000000001",
    "0000000000040300000030001",
    "0000000000040300000000031",
    "0000000000040300003000001",
    "0000000000043000003000001",
    "0000000000403000003000001"
  ]
}
