{
  "puzzle_info": {
    "grid_width": 5,
    "grid_height": 5,
    "steps_to_solve": 12
  },
  "solution_path": [
    "4000010000041000000000000",
    "0000410000041000000000000",
    "0000410000001000000004000",
    "0000410000001000000000004",
    "0000010000001000000400004",
    "0000010000001004000000004",
    "0000410000001004000000000",
    "0000410000001000000400000",
    "0000010000001040000400000",
    "0000010000001400000400000",
    "0000010000001404000000000",
    "0000010000401400000000000",
    "0000010000041400000000000"
  ]
}
