{
  "puzzle_info": {
    "grid_width": 5,
    "grid_height": 5,
    "steps_to_solve": 10
  },
  "solution_path": [
    "0000000100400000000003000",
    "0000000100000040000003000",
    "0300000100000040000000000",
    "0000300100000040000000000",
    "0000300104000000000000000",
    "3000000104000000000000000",
    "0000000104000000000030000",
    "0000000104000000000000003",
    "0000000104000030000000000",
    "0000000140000030000000000",
    "0000000140300000000000000"
  ]
}
