{
  "puzzle_info": {
    "grid_width": 4,
    "grid_height": 4,
    "steps_to_solve": 14
  },
  "solution_path": [
    "0000000030002040",
    "3000000000002040",
    "3000000000000240",
    "3040000000000200",
    "3400000000000200",
    "3000000004000200",
    "0003000004000200",
    "0000000004000203",
    "0000000004000023",
    "0020000004000003",
    "0020000004003000",
    "3020000004000000",
    "0320000004000000",
    "0020030004000000",
    "0020300004000000"
  ]
}
