{
  "puzzle_info": {
    "grid_width": 4,
    "grid_height": 4,
    "steps_to_solve": 13
  },
  "solution_path": [
    "2000300400000004",
    "2000003400000004",
    "2000003400040000",
    "2000003440000000",
    "0000203440000000",
    "0000230440000000",
    "0000234040000000",
    "0000204040000300",
    "0000024040000300",
    "0000024000040300",
    "0000024000000304",
    "0000024000000340",
    "0000024003000040",
    "0200004003000040"
  ]
}
