{
  "puzzle_info": {
    "grid_width": 4,
    "grid_height": 4,
    "steps_to_solve": 12
  },
  "solution_path": [
    "0020002300020000",
    "2000002300020000",
    "2000002320000000",
    "0000202320000000",
    "0000022320000000",
    "0020020320000000",
    "0020023020000000",
    "0020020020000030",
    "0000020020200030",
    "0000020022000030",
    "0000020002002030",
    "0000020002000230",
    "0000020002000203"
  ]
}
