{
  "puzzle_info": {
    "grid_width": 4,
    "grid_height": 4,
    "steps_to_solve": 14
  },
  "solution_path": [
    "0400120000300002",
    "0004120000300002",
    "0004120000000032",
    "0004120000003002",
    "0004120200003000",
    "0004122000003000",
    "0000122000003004",
    "0000102000003204",
    "0000102000003024",
    "0000102000000324",
    "0000102000200304",
    "0000102000200340",
    "0000102000203040",
    "0000102030200040",
    "0000102003200040"
  ]
}
