{
  "puzzle_info": {
    "grid_width": 4,
    "grid_height": 4,
    "steps_to_solve": 12
  },
  "solution_path": [
    "0200200000130003",
    "0002200000130003",
    "0002200000133000",
    "0002200000103003",
    "0002200000103300",
    "0000200000103302",
    "0000200030100302",
    "0000000230100302",
    "0000000230100320",
    "0300000230100020",
    "0300000203100020",
    "0000030203100020",
    "0000030230100020"
  ]
}
