{
  "puzzle_info": {
    "grid_width": 4,
    "grid_height": 4,
    "steps_to_solve": 14
  },
  "solution_path": [
    "3010004200000040",
    "0010004200003040",
    "0010400200003040",
    "0010420000003040",
    "0010420000003004",
    "0010420000000034",
    "0010020000004034",
    "0010000000004234",
    "0010003000004204",
    "0010003000004024",
    "0010003000000424",
    "0010003000200404",
    "0010003000200440",
    "0410003000200040",
    "4010003000200040"
  ]
}
