{
  "puzzle_info": {
    "grid_width": 4,
    "grid_height": 4,
    "steps_to_solve": 14
  },
  "solution_path": [
    "4400000000000022",
    "0400000000004022",
    "0004000000004022",
    "0004000000004202",
    "4004000000000202",
    "0044000000000202",
    "0044000000000220",
    "0040000000000224",
    "0040002000000204",
    "0040002000000240",
    "0040002000400200",
    "0040200000400200",
    "0000204000400200",
    "0000024000400200",
    "0040020000400200"
  ]
}
