{
  "puzzle_info": {
    "grid_width": 4,
    "grid_height": 4,
    "steps_to_solve": 13
  },
  "solution_path": [
    "0000000002304000",
    "0030000002004000",
    "4030000002000000",
    "4300000002000000",
    "4000030002000000",
    "0004030002000000",
    "0004030000020000",
    "0004030200000000",
    "4000030200000000",
    "0000030200004000",
    "0000030200000004",
    "0000030200040000",
    "0000032000040000",
    "0000002000040300"
  ]
}
