{
  "puzzle_info": {
    "grid_width": 4,
    "grid_height": 4,
    "steps_to_solve": 14
  },
  "solution_path": [
    "0043002001200000",
    "0043200001200000",
    "0003204001200000",
    "0003024001200000",
    "0003024001020000",
    "0000024301020000",
    "0000024301000002",
    "0000024301002000",
    "0000020301002040",
    "0000023001002040",
    "0000203001002040",
    "0000003021002040",
    "0000003021000240",
    "0000003021400200",
    "0000003021040200"
  ]
}
