{
  "puzzle_info": {
    "grid_width": 4,
    "grid_height": 4,
    "steps_to_solve": 13
  },
  "solution_path": [
    "4300000000400200",
    "0300000000404200",
    "0300000000404002",
    "0000000000404302",
    "0000000000404032",
    "0000000000400432",
    "0400000000400032",
    "0402000000400030",
    "0420000000400030",
    "0400002000400030",
    "0400002040000030",
    "0400002040300000",
    "0400002004300000",
    "0400002004030000"
  ]
}
