{
  "puzzle_info": {
    "grid_width": 4,
    "grid_height": 4,
    "steps_to_solve": 12
  },
  "solution_path": [
    "1000030000000002",
    "1000030000002000",
    "1000000000002300",
    "1000200000000300",
    "1000000200000300",
    "1000000200003000",
    "1000300200000000",
    "1000003200000000",
    "1000003000000002",
    "1000003000002000",
    "1000203000000000",
    "1000023000000000",
    "1000020300000000"
  ]
}
