{
  "puzzle_info": {
    "grid_width": 4,
    "grid_height": 4,
    "steps_to_solve": 11
  },
  "solution_path": [
    "0003030000001000",
    "0000030000001003",
    "0000000300001003",
    "0000000300031000",
    "0000300000031000",
    "0000000030031000",
    "0000000000331000",
    "0003000000301000",
    "3000000000301000",
    "0000000030301000",
    "0000000003301000",
    "0000000003001030"
  ]
}
