{
  "puzzle_info": {
    "grid_width": 4,
    "grid_height": 4,
    "steps_to_solve": 12
  },
  "solution_path": [
    "0000002000030200",
    "0003002000000200",
    "0003000200000200",
    "0003000200000002",
    "0003000000020002",
    "0000000300020002",
    "0000000320000002",
    "0000000320020000",
    "0000000322000000",
    "0000000302002000",
    "0000000302000002",
    "0000000302020000",
    "0000000302200000"
  ]
}
