{
  "puzzle_info": {
    "grid_width": 4,
    "grid_height": 4,
    "steps_to_solve": 13
  },
  "solution_path": [
    "0400000400200020",
    "0404000000200020",
    "0044000000200020",
    "0040000000200024",
    "0040000020000024",
    "0040000000002024",
    "0040000000000224",
    "0040002000000204",
    "0040002000000240",
    "0040002000400200",
    "0040200000400200",
    "0000204000400200",
    "0000024000400200",
    "0040020000400200"
  ]
}
