{
  "puzzle_info": {
    "grid_width": 4,
    "grid_height": 4,
    "steps_to_solve": 11
  },
  "solution_path": [
    "0103000040300100",
    "0100000040300103",
    "4100000000300103",
    "4100000030000103",
    "0100400030000103",
    "0100000430000103",
    "0100000430030100",
    "0100000433000100",
    "0100000403003100",
    "0100030400003100",
    "0100034000003100",
    "0100304000003100"
  ]
}
