{
  "puzzle_info": {
    "grid_width": 4,
    "grid_height": 4,
    "steps_to_solve": 13
  },
  "solution_path": [
    "0000400040000340",
    "4000000040000340",
    "0004000040000340",
    "0304000040000040",
    "0034000040000040",
    "0004000040300040",
    "4000000040300040",
    "4000000004300040",
    "4000000004030040",
    "4040000004030000",
    "0440000004030000",
    "0440000004300000",
    "0400004004300000",
    "0400004004030000"
  ]
}
