{
  "puzzle_info": {
    "grid_width": 5,
    "grid_height": 5,
    "steps_to_solve": 16
  },
  "solution_path": [
    "0100000000000040000300200",
    "0100000000400000000300200",
    "0100300000400000000000200",
    "0100300000000040000000200",
    "0100300004000000000000200",
    "0130000004000000000000200",
    "0130000204000000000000000",
    "0130000024000000000000000",
    "0100000024000000000000300",
    "0100400020000000000000300",
    "0140000020000000000000300",
    "0100000020000000040000300",
    "0100000020000000040000003",
    "0100300020000000040000000",
    "0130000020000000040000000",
    "0100000020003000040000000",
    "0100000020300000040000000"
  ]
}
