{
  "puzzle_info": {
    "grid_width": 5,
    "grid_height": 5,
    "steps_to_solve": 15
  },
  "solution_path": [
    "0000001000000340001400000",
    "0000001000300040001400000",
    "0000001000000040001430000",
    "0000001000400000001430000",
    "0000001000000004001430000",
    "0000001000000000041430000",
    "0000401000000000041030000",
    "4000001000000000041030000",
    "0000001000000004041030000",
    "0000001000000000441030000",
    "0040001000000000401030000",
    "0040001000000000401000003",
    "0040301000000000401000000",
    "0043001000000000401000000",
    "0003001000000000401000400",
    "0000001000000300401000400"
  ]
}
