{
  "puzzle_info": {
    "grid_width": 4,
    "grid_height": 4,
    "steps_to_solve": 13
  },
  "solution_path": [
    "0023400000000000",
    "2003400000000000",
    "2300400000000000",
    "2300000400000000",
    "2304000000000000",
    "2340000000000000",
    "2040000000000300",
    "0240000000000300",
    "0040000002000300",
    "0040000002003000",
    "3040000002000000",
    "0340000002000000",
    "0040030002000000",
    "0040300002000000"
  ]
}
