{
  "puzzle_info": {
    "grid_width": 5,
    "grid_height": 5,
    "steps_to_solve": 18
  },
  "solution_path": [
    "0002000000440000000000200",
    "4002000000040000000000200",
    "4200000000040000000000200",
    "0200000000040000000040200",
    "0200000000040000000004200",
    "0200000000040000400000200",
    "0200000000000040400000200",
    "0000000000020040400000200",
    "0000000000024000400000200",
    "0000000000024000420000000",
    "0040000000020000420000000",
    "0040000000020000400200000",
    "0040000000020000004200000",
    "0040200000020000004000000",
    "0042000000020000004000000",
    "0040000000020200004000000",
    "0040000000022000004000000",
    "0000000400022000004000000",
    "0000000400020000004000200"
  ]
}
