{
  "puzzle_info": {
    "grid_width": 4,
    "grid_height": 4,
    "steps_to_solve": 13
  },
  "solution_path": [
    "0040002000010100",
    "0004002000010100",
    "0000002400010100",
    "0020000400010100",
    "0002000400010100",
    "0002400000010100",
    "0000400200010100",
    "0000420000010100",
    "4000020000010100",
    "0004020000010100",
    "0000020400010100",
    "0000024000010100",
    "0000020000010140",
    "0000020000010104"
  ]
}
