{
  "puzzle_info": {
    "grid_width": 4,
    "grid_height": 4,
    "steps_to_solve": 12
  },
  "solution_path": [
    "0042040004000000",
    "0002040004000040",
    "0000040004000042",
    "0000040000040042",
    "0000040000044002",
    "0000040000044200",
    "4000040000040200",
    "0004040000040200",
    "0000040400040200",
    "0000044000040200",
    "0000044002040000",
    "0400004002040000",
    "4000004002040000"
  ]
}
