{
  "puzzle_info": {
    "grid_width": 4,
    "grid_height": 4,
    "steps_to_solve": 10
  },
  "solution_path": [
    "0000100300003000",
    "0000100300000003",
    "0000100000030003",
    "0000100000033000",
    "0000100030030000",
    "0000100000330000",
    "0000100000300003",
    "0000100000303000",
    "0000100030300000",
    "0000100003300000",
    "0000100003000030"
  ]
}
