{
  "puzzle_info": {
    "grid_width": 4,
    "grid_height": 4,
    "steps_to_solve": 13
  },
  "solution_path": [
    "1002000000004000",
    "1002000000000004",
    "1000000000020004",
    "1000000020000004",
    "1000200000000004",
    "1000000200000004",
    "1000000200004000",
    "1000400200000000",
    "1000004200000000",
    "1000004000000002",
    "1000004000002000",
    "1000204000000000",
    "1000024000000000",
    "1000020400000000"
  ]
}
