{
  "puzzle_info": {
    "grid_width": 5,
    "grid_height": 5,
    "steps_to_solve": 18
  },
  "solution_path": [
    "0000300040020000000030000",
    "0000340000020000000030000",
    "0200340000000000000030000",
    "0230040000000000000030000",
    "0200040000000000000030300",
    "0200040000000000000003300",
    "0200000000000000000043300",
    "0200003000000000000040300",
    "0200003000000000000004300",
    "0200003000040000000000300",
    "0200000003040000000000300",
    "0000002003040000000000300",
    "0000000023040000000000300",
    "0000000020040000000000303",
    "0000000020040000000000330",
    "0000000020040300000000300",
    "0000000020043000000000300",
    "0000000020043000030000000",
    "0000000020040030030000000"
  ]
}
