{
  "puzzle_info": {
    "grid_width": 4,
    "grid_height": 4,
    "steps_to_solve": 13
  },
  "solution_path": [
    "0000000230020000",
    "0002000030020000",
    "2000000030020000",
    "2002000030000000",
    "0022000030000000",
    "3022000000000000",
    "0322000000000000",
    "0302000000000020",
    "0320000000000020",
    "0300000000200020",
    "0300000000200002",
    "0302000000200000",
    "0320000000200000",
    "0020000000200300"
  ]
}
