{
  "puzzle_info": {
    "grid_width": 4,
    "grid_height": 4,
    "steps_to_solve": 13
  },
  "solution_path": [
    "0000003420004000",
    "0000300420004000",
    "0000300420000004",
    "0000300020040004",
    "0000300000240004",
    "0000300000244000",
    "0000000030244000",
    "0000000003244000",
    "0020000003044000",
    "0020000003404000",
    "4020000003400000",
    "0420000003400000",
    "0400002003400000",
    "0400002003040000"
  ]
}
