{
  "puzzle_info": {
    "grid_width": 5,
    "grid_height": 5,
    "steps_to_solve": 18
  },
  "solution_path": [
    "0040021001000302000000000",
    "0000021001000302000000400",
    "0000021001000300000200400",
    "0000021001000300000000402",
    "0000021001000300000000042",
    "0000021001000300004000002",
    "0000021001000300004020000",
    "0000001001000302004020000",
    "0000001001300002004020000",
    "0000001001300000024020000",
    "0000001001000003024020000",
    "0000001001000000324020000",
    "0020001001000000304020000",
    "2020001001000000304000000",
    "0220001001000000304000000",
    "0200001001000000304000200",
    "0200001001000000304000002",
    "0200001001000020304000000",
    "0200001001200000304000000"
  ]
}
