{
  "puzzle_info": {
    "grid_width": 5,
    "grid_height": 5,
    "steps_to_solve": 14
  },
  "solution_path": [
    "0000400200021000000000000",
    "0000000200021000000000004",
    "0000000002021000000000004",
    "0000000000021000000200004",
    "0000000000001000000202004",
    "0000000000001000000202400",
    "0200000000001000000200400",
    "0000200000001000000200400",
    "0000000000001020000200400",
    "0000000000001020000000402",
    "0000000000001020000000420",
    "0002000000001020000000400",
    "0002000000001200000000400",
    "0000000020001200000000400",
    "0000000020001020000000400"
  ]
}
