{
  "puzzle_info": {
    "grid_width": 4,
    "grid_height": 4,
    "steps_to_solve": 13
  },
  "solution_path": [
    "0004003000000004",
    "4000003000000004",
    "0000003000004004",
    "0000000000004034",
    "0000000000004304",
    "0000000000004340",
    "0300000000004040",
    "0300000000000440",
    "0300040000000040",
    "3000040000000040",
    "0000040000003040",
    "0000040000000340",
    "0000040003000040",
    "0000000403000040"
  ]
}
