{
  "puzzle_info": {
    "grid_width": 4,
    "grid_height": 4,
    "steps_to_solve": 13
  },
  "solution_path": [
    "0230000000020000",
    "0030000000020200",
    "0030000000000202",
    "0030000000000220",
    "0030002000000200",
    "0003002000000200",
    "0000002000000203",
    "0000002000000023",
    "0000002000200003",
    "0000200000200003",
    "0000200000203000",
    "0000200030200000",
    "0000200003200000",
    "0300200000200000"
  ]
}
