{
  "puzzle_info": {
    "grid_width": 5,
    "grid_height": 5,
    "steps_to_solve": 16
  },
  "solution_path": [
    "0010000003000400000000000",
    "0010000000000400000000003",
    "0010000000000400000030000",
    "0010000000000000000030040",
    "0010000000000000000034000",
    "3010000000000000000004000",
    "0310000000000000000004000",
    "0010000000000000300004000",
    "0010000000000000300040000",
    "4010000000000000300000000",
    "0410000000000000300000000",
    "0010000000040000300000000",
    "0010000000040003000000000",
    "3010000000040000000000000",
    "0310000000040000000000000",
    "0010003000040000000000000",
    "0010003000000040000000000"
  ]
}
