{
  "puzzle_info": {
    "grid_width": 4,
    "grid_height": 4,
    "steps_to_solve": 14
  },
  "solution_path": [
    "0012000000012000",
    "0010000200012000",
    "0010200000012000",
    "2010000000012000",
    "0210000000012000",
    "0010000000012200",
    "2010000000010200",
    "0210000000010200",
    "0010000002010200",
    "0010000002012000",
    "2010000002010000",
    "0210000002010000",
    "0010020002010000",
    "0010000202010000",
    "0012000002010000"
  ]
}
