{
  "puzzle_info": {
    "grid_width": 4,
    "grid_height": 4,
    "steps_to_solve": 13
  },
  "solution_path": [
    "0001000030004000",
    "0001000000034000",
    "0001000000004003",
    "0001000000000043",
    "0001000300000040",
    "0001300000000040",
    "3001000000000040",
    "0031000000000040",
    "0001000000300040",
    "0001000000304000",
    "4001000000300000",
    "0041000000300000",
    "0001004000300000",
    "0001004000030000"
  ]
}
