{
  "puzzle_info": {
    "grid_width": 4,
    "grid_height": 4,
    "steps_to_solve": 13
  },
  "solution_path": [
    "0030020204000000",
    "0000020204000030",
    "0000200204000030",
    "0000200204000003",
    "0000200004020003",
    "0000200000420003",
    "0040200000020003",
    "0040200000023000",
    "0040000020023000",
    "0040000000223000",
    "3040000000220000",
    "0340000000220000",
    "0300004000220000",
    "0300004020020000"
  ]
}
