{
  "puzzle_info": {
    "grid_width": 4,
    "grid_height": 4,
    "steps_to_solve": 13
  },
  "solution_path": [
    "0000200040000001",
    "0000200000040001",
    "0000000000042001",
    "0000000040002001",
    "0000000040000021",
    "0000000000004021",
    "0020000000004001",
    "0020000000000041",
    "0020004000000001",
    "2000004000000001",
    "0000004000002001",
    "0000004000000021",
    "0000004000200001",
    "0000000400200001"
  ]
}
