{
  "puzzle_info": {
    "grid_width": 4,
    "grid_height": 4,
    "steps_to_solve": 13
  },
  "solution_path": [
    "0000000300003040",
    "0003000000003040",
    "0003000000000340",
    "0303000000000040",
    "0330000000000040",
    "0330000000004000",
    "0300000000004030",
    "0300000000000430",
    "0300040000000030",
    "3000040000000030",
    "0000040000003030",
    "0000040000000330",
    "0000040003000030",
    "0000040030000030"
  ]
}
