{
  "puzzle_info": {
    "grid_width": 4,
    "grid_height": 4,
    "steps_to_solve": 11
  },
  "solution_path": [
    "0000004000204000",
    "0040000000204000",
    "0040002000004000",
    "0004002000004000",
    "0000002000004004",
    "0000002000000044",
    "0000002000400004",
    "0000200000400004",
    "0000200000404000",
    "0000200040400000",
    "0000000240400000",
    "0000000204400000"
  ]
}
