{
  "puzzle_info": {
    "grid_width": 4,
    "grid_height": 4,
    "steps_to_solve": 12
  },
  "solution_path": [
    "0430000000004004",
    "0400000000004034",
    "0400000000004304",
    "0400000000004340",
    "0400030000004040",
    "4000030000004040",
    "0000030040004040",
    "0000030000044040",
    "0000030000040440",
    "0000030004040040",
    "0040030004040000",
    "0040030004400000",
    "0040030040400000"
  ]
}
