{
  "puzzle_info": {
    "grid_width": 4,
    "grid_height": 4,
    "steps_to_solve": 11
  },
  "solution_path": [
    "3023000000300000",
    "0323000000300000",
    "0323000000000030",
    "0303000000200030",
    "0303000000200003",
    "0303000300200000",
    "0330000300200000",
    "0030000300200300",
    "0030300000200300",
    "0000303000200300",
    "0000033000200300",
    "0030030000200300"
  ]
}
