{
  "puzzle_info": {
    "grid_width": 4,
    "grid_height": 4,
    "steps_to_solve": 14
  },
  "solution_path": [
    "0000000200000430",
    "0002000000000430",
    "2000000000000430",
    "2030000000000400",
    "0230000000000400",
    "0030000002000400",
    "0030000002004000",
    "4030000002000000",
    "4300000002000000",
    "4000030002000000",
    "0004030002000000",
    "0004030000020000",
    "0000030400020000",
    "0000034000020000",
    "0000030000020040"
  ]
}
