{
  "puzzle_info": {
    "grid_width": 4,
    "grid_height": 4,
    "steps_to_solve": 10
  },
  "solution_path": [
    "1001000000003020",
    "1021000000003000",
    "1201000000003000",
    "1201000000000003",
    "1001000000000203",
    "1001000000000230",
    "1201000000000030",
    "1021000000000030",
    "1001000000200030",
    "1001000000200003",
    "1001000300200000"
  ]
}
