{
  "puzzle_info": {
    "grid_width": 4,
    "grid_height": 4,
    "steps_to_solve": 11
  },
  "solution_path": [
    "0004004204000000",
    "0004400204000000",
    "0004420004000000",
    "0004420000040000",
    "0000420400040000",
    "0000400400040200",
    "0000440000040200",
    "4000040000040200",
    "0004040000040200",
    "0004040002040000",
    "0004040002400000",
    "0004040020400000"
  ]
}
