{
  "puzzle_info": {
    "grid_width": 4,
    "grid_height": 4,
    "steps_to_solve": 12
  },
  "solution_path": [
    "0003000430000000",
    "0003000030000004",
    "0003000000030004",
    "0003000300000004",
    "0003000300040000",
    "0003300000040000",
    "0000300300040000",
    "0000330000040000",
    "3000030000040000",
    "0003030000040000",
    "0000030300040000",
    "0000033000040000",
    "0030030000040000"
  ]
}
