{
  "puzzle_info": {
    "grid_width": 4,
    "grid_height": 4,
    "steps_to_solve": 10
  },
  "solution_path": [
    "0200000002002000",
    "2000000002002000",
    "0000000022002000",
    "0000000020022000",
    "0000000000222000",
    "0002000000202000",
    "2002000000200000",
    "0022000000200000",
    "0002002000200000",
    "2000002000200000",
    "2000002000000020"
  ]
}
