{
  "puzzle_info": {
    "grid_width": 4,
    "grid_height": 4,
    "steps_to_solve": 11
  },
  "solution_path": [
    "0410030100200000",
    "4010030100200000",
    "4010300100200000",
    "4010302100000000",
    "4010320100000000",
    "4010020100003000",
    "0010020140003000",
    "0010020140000003",
    "0010020140030000",
    "0010020100430000",
    "0010020100400003",
    "0010020100403000"
  ]
}
