{
  "puzzle_info": {
    "grid_width": 4,
    "grid_height": 4,
    "steps_to_solve": 12
  },
  "solution_path": [
    "0000003030000400",
    "3000003000000400",
    "3000003000004000",
    "3000403000000000",
    "0003403000000000",
    "0003430000000000",
    "4003030000000000",
    "0043030000000000",
    "0003030000000040",
    "3000030000000040",
    "0000030000003040",
    "0000030000000340",
    "0040030000000300"
  ]
}
