{
  "puzzle_info": {
    "grid_width": 4,
    "grid_height": 4,
    "steps_to_solve": 14
  },
  "solution_path": [
    "0340000000002300",
    "0040000003002300",
    "0040000000032300",
    "2040000000030300",
    "0240000000030300",
    "0040000002030300",
    "0000000002030340",
    "0000000002030304",
    "0000000002030034",
    "0030000002030004",
    "0030000002300004",
    "0030000002304000",
    "4030000002300000",
    "0430000002300000",
    "0400003002300000"
  ]
}
