{
  "puzzle_info": {
    "grid_width": 4,
    "grid_height": 4,
    "steps_to_solve": 12
  },
  "solution_path": [
    "4400000000400200",
    "0400000000404200",
    "0400000000004240",
    "0400020000004040",
    "0400020000000440",
    "0400000002000440",
    "0000040002000440",
    "0000040000020440",
    "0000040004020040",
    "0000040004200040",
    "0000040000200440",
    "0000040000200404",
    "0004040000200400"
  ]
}
