{
  "puzzle_info": {
    "grid_width": 4,
    "grid_height": 4,
    "steps_to_solve": 12
  },
  "solution_path": [
    "0310004000000000",
    "0010004000000300",
    "0010000000000340",
    "0010000000003040",
    "0010000000003400",
    "3010000000000400",
    "0310000000000400",
    "0010000003000400",
    "0010000003004000",
    "4010000003000000",
    "0410000003000000",
    "0010040003000000",
    "0010040030000000"
  ]
}
