{
  "puzzle_info": {
    "grid_width": 4,
    "grid_height": 4,
    "steps_to_solve": 12
  },
  "solution_path": [
    "0000000030000043",
    "0000000030004003",
    "0003000030004000",
    "3000000030004000",
    "0000300030004000",
    "0000300000034000",
    "0000300040030000",
    "0000000340030000",
    "0000000343000000",
    "0000000303004000",
    "0000000303000004",
    "0000000303040000",
    "0000000303400000"
  ]
}
