{
  "puzzle_info": {
    "grid_width": 4,
    "grid_height": 4,
    "steps_to_solve": 12
  },
  "solution_path": [
    "2000004000040000",
    "0002004000040000",
    "0000004200040000",
    "0000000200040040",
    "0000200000040040",
    "0000200000044000",
    "0000200040040000",
    "0000200000440000",
    "0000200000400004",
    "0000200000404000",
    "0000200040400000",
    "0000200004400000",
    "0000200000400400"
  ]
}
