{
  "puzzle_info": {
    "grid_width": 4,
    "grid_height": 4,
    "steps_to_solve": 13
  },
  "solution_path": [
    "2000000000002004",
    "0000000020002004",
    "0004000020002000",
    "4000000020002000",
    "4000000000022000",
    "4000200000020000",
    "0004200000020000",
    "0000200400020000",
    "0000240000020000",
    "2000040000020000",
    "0002040000020000",
    "0000040200020000",
    "0000042000020000",
    "0400002000020000"
  ]
}
