{
  "puzzle_info": {
    "grid_width": 4,
    "grid_height": 4,
    "steps_to_solve": 12
  },
  "solution_path": [
    "0000000000333200",
    "0000000000303203",
    "3000000000300203",
    "3000000000300023",
    "3003000000300020",
    "0033000000300020",
    "0003003000300020",
    "3000003000300020",
    "3000003030000020",
    "0000303030000020",
    "0000033030000020",
    "0000033030200000",
    "0000030330200000"
  ]
}
