{
  "puzzle_info": {
    "grid_width": 4,
    "grid_height": 4,
    "steps_to_solve": 13
  },
  "solution_path": [
    "2000030000004000",
    "2000000000004300",
    "2000400000000300",
    "2000400000003000",
    "2000000040003000",
    "0000200040003000",
    "0000200000043000",
    "0000200030040000",
    "0000200000340000",
    "0000200000300004",
    "0000200000304000",
    "0000200040300000",
    "0000200004300000",
    "0000200004000030"
  ]
}
