{
  "puzzle_info": {
    "grid_width": 5,
    "grid_height": 5,
    "steps_to_solve": 17
  },
  "solution_path": [
    "0000040000202200000000000",
    "4000000000202200000000000",
    "4000000000200200000000200",
    "4000000000220000000000200",
    "4000000000020000000020200",
    "4000000000020000000002200",
    "4000000000020000200000200",
    "4000000000000020200000200",
    "4020000000000020200000000",
    "0420000000000020200000000",
    "0020000000040020200000000",
    "0020000000042000200000000",
    "0000000200042000200000000",
    "0000000200040000200000200",
    "0000000200000040200000200",
    "0000000200002040200000000",
    "0000000200002400200000000",
    "0000000200000400200000200"
  ]
}
