{
  "puzzle_info": {
    "grid_width": 4,
    "grid_height": 4,
    "steps_to_solve": 13
  },
  "solution_path": [
    "0400000400030000",
    "0004000400030000",
    "0004400000030000",
    "0004400300000000",
    "0004430000000000",
    "0000430000000004",
    "0000030000004004",
    "0000030000004400",
    "0000030004004000",
    "0000000304004000",
    "0000000304000004",
    "0000000304040000",
    "0000000304400000",
    "0040000304000000"
  ]
}
