{
  "puzzle_info": {
    "grid_width": 4,
    "grid_height": 4,
    "steps_to_solve": 10
  },
  "solution_path": [
    "0000000001000240",
    "0000000001002040",
    "2000000001000040",
    "2000000001004000",
    "2000400001000000",
    "0002400001000000",
    "0000400001000002",
    "0000000401000002",
    "0000000401020000",
    "0000400001020000",
    "0000400001200000"
  ]
}
