{
  "puzzle_info": {
    "grid_width": 5,
    "grid_height": 5,
    "steps_to_solve": 14
  },
  "solution_path": [
    "0020000000004000000004000",
    "0000000200004000000004000",
    "0000020000004000000004000",
    "0000020000000040000004000",
    "0000020000000040000040000",
    "0000020000400040000000000",
    "2000000000400040000000000",
    "2000000000000440000000000",
    "2000400000000400000000000",
    "2400000000000400000000000",
    "0400000000000400000020000",
    "0400000000000400000000002",
    "0000000000000400000004002",
    "0000000000000400000004200",
    "0020000000000400000004000"
  ]
}
