{
  "puzzle_info": {
    "grid_width": 4,
    "grid_height": 4,
    "steps_to_solve": 11
  },
  "solution_path": [
    "0300320000000003",
    "0300020000003003",
    "0300020000003300",
    "0300020003003000",
    "0300000203003000",
    "0000030203003000",
    "0000032003003000",
    "0000032003000003",
    "0000032000000303",
    "0000032000000330",
    "0000032000300300",
    "0020030000300300"
  ]
}
