{
  "puzzle_info": {
    "grid_width": 4,
    "grid_height": 4,
    "steps_to_solve": 12
  },
  "solution_path": [
    "0303040002000000",
    "0303040000000200",
    "0303000004000200",
    "0303000000040200",
    "0003000003040200",
    "0003000003400200",
    "0003000030400200",
    "0203000030400000",
    "0023000030400000",
    "0003002030400000",
    "3000002030400000",
    "0000302030400000",
    "0000032030400000"
  ]
}
