{
  "puzzle_info": {
    "grid_width": 4,
    "grid_height": 4,
    "steps_to_solve": 12
  },
  "solution_path": [
    "0000000020000023",
    "0020000020000003",
    "2000000020000003",
    "0000200020000003",
    "0000200000020003",
    "0000200000023000",
    "0000200030020000",
    "0000000230020000",
    "0000000232000000",
    "0000000202003000",
    "0000000202000003",
    "0000000202030000",
    "0000000202300000"
  ]
}
