{
  "puzzle_info": {
    "grid_width": 4,
    "grid_height": 4,
    "steps_to_solve": 12
  },
  "solution_path": [
    "4030000020000020",
    "4300000020000020",
    "4300000000002020",
    "0300000040002020",
    "0300000000042020",
    "0300000000040220",
    "0300020000040020",
    "0003020000040020",
    "0000020300040020",
    "0000023000040020",
    "0000023040000020",
    "0000023040200000",
    "0000020340200000"
  ]
}
