{
  "puzzle_info": {
    "grid_width": 4,
    "grid_height": 4,
    "steps_to_solve": 12
  },
  "solution_path": [
    "0000200040040000",
    "0000000240040000",
    "0000000244000000",
    "0000000204004000",
    "0000000204000004",
    "0000000004020004",
    "0000000004200004",
    "0400000000200004",
    "0404000000200000",
    "0440000000200000",
    "0040000000200400",
    "0000004000200400",
    "0000004000020400"
  ]
}
