{
  "puzzle_info": {
    "grid_width": 4,
    "grid_height": 4,
    "steps_to_solve": 12
  },
  "solution_path": [
    "3003000000034000",
    "0003000030034000",
    "0003000033004000",
    "3003000003004000",
    "3300000003004000",
    "3300400003000000",
    "3300000403000000",
    "0300000403003000",
    "0000030403003000",
    "0000030403000003",
    "0000030403030000",
    "0000030403300000",
    "0000030400300300"
  ]
}
