{
  "puzzle_info": {
    "grid_width": 4,
    "grid_height": 4,
    "steps_to_solve": 10
  },
  "solution_path": [
    "0400400000040400",
    "0000400004040400",
    "4000000004040400",
    "0004000004040400",
    "0004000004400400",
    "0004000040400400",
    "0404000040400000",
    "0440000040400000",
    "0400004040400000",
    "0400004004400000",
    "0400004004000040"
  ]
}
