{
  "puzzle_info": {
    "grid_width": 4,
    "grid_height": 4,
    "steps_to_solve": 14
  },
  "solution_path": [
    "1004000000030000",
    "1000000400030000",
    "1000400000030000",
    "1003400000000000",
    "1300400000000000",
    "1000400000000300",
    "1000000400000300",
    "1004000000000300",
    "1400000000000300",
    "1000000004000300",
    "1000000004000003",
    "1003000004000000",
    "1300000004000000",
    "1000030004000000",
    "1000030000040000"
  ]
}
