{
  "puzzle_info": {
    "grid_width": 4,
    "grid_height": 4,
    "steps_to_solve": 12
  },
  "solution_path": [
    "0000200040300000",
    "0000200040030000",
    "0000200000430000",
    "0000200000400003",
    "0000200000403000",
    "0000000020403000",
    "0000000002403000",
    "0040000002003000",
    "3040000002000000",
    "0340000002000000",
    "0040030002000000",
    "0000030002000040",
    "0000030020000040"
  ]
}
