{
  "puzzle_info": {
    "grid_width": 4,
    "grid_height": 4,
    "steps_to_solve": 13
  },
  "solution_path": [
    "0430000000000003",
    "0030000000000403",
    "0030000000000043",
    "0030004000000003",
    "3000004000000003",
    "3000004000003000",
    "3000304000000000",
    "3000034000000000",
    "0000034000003000",
    "0000030000003040",
    "0000030000000340",
    "0000030003000040",
    "0000000303000040",
    "0040000303000000"
  ]
}
