{
  "puzzle_info": {
    "grid_width": 4,
    "grid_height": 4,
    "steps_to_solve": 12
  },
  "solution_path": [
    "0404030000000040",
    "0400030000000044",
    "0400000000000344",
    "0440000000000304",
    "0440000000000034",
    "0400000000400034",
    "0404000000400030",
    "0440000000400030",
    "0400004000400030",
    "0400004040000030",
    "0400004040300000",
    "0400004004300000",
    "0400004004030000"
  ]
}
