{
  "puzzle_info": {
    "grid_width": 4,
    "grid_height": 4,
    "steps_to_solve": 12
  },
  "solution_path": [
    "0030000000000021",
    "0030002000000001",
    "0003002000000001",
    "0003000200000001",
    "0003000000020001",
    "0003000020000001",
    "0000000020030001",
    "0000000023000001",
    "2000000003000001",
    "0002000003000001",
    "0000000003020001",
    "0000000003200001",
    "0000000030200001"
  ]
}
