{
  "puzzle_info": {
    "grid_width": 5,
    "grid_height": 5,
    "steps_to_solve": 18
  },
  "solution_path": [
    "0000000010000003000401004",
    "0000000010000000003401004",
    "0000000010000000003401400",
    "0000000010000000003001404",
    "0040000010000000003001004",
    "0040000010000000003001400",
    "0040000010000000000001430",
    "0040000410000000000001030",
    "0040000410000000000001300",
    "0040000410003000000001000",
    "0040040010003000000001000",
    "0000040410003000000001000",
    "0000004410003000000001000",
    "0040004010003000000001000",
    "0000404010003000000001000",
    "0000004010003000000001004",
    "0000004010003000000001400",
    "0000004010003000040001000",
    "0000004010003004000001000"
  ]
}
