{
  "puzzle_info": {
    "grid_width": 4,
    "grid_height": 4,
    "steps_to_solve": 10
  },
  "solution_path": [
    "1200000004001000",
    "1200040000001000",
    "1002040000001000",
    "1000040000001002",
    "1000000400001002",
    "1000000400021000",
    "1000000420001000",
    "1000200400001000",
    "1000002400001000",
    "1004002000001000",
    "1400002000001000"
  ]
}
