{
  "puzzle_info": {
    "grid_width": 4,
    "grid_height": 4,
    "steps_to_solve": 10
  },
  "solution_path": [
    "0000003000010300",
    "0000300000010300",
    "0300300000010000",
    "0003300000010000",
    "0000300300010000",
    "0000330000010000",
    "3000030000010000",
    "0003030000010000",
    "0000030300010000",
    "0000033000010000",
    "0000030000010030"
  ]
}
