{
  "puzzle_info": {
    "grid_width": 4,
    "grid_height": 4,
    "steps_to_solve": 13
  },
  "solution_path": [
    "4001400000000003",
    "0041400000000003",
    "4041000000000003",
    "0441000000000003",
    "0041000000000403",
    "0041000000000430",
    "0001000000400430",
    "0401000000400030",
    "0041000000400030",
    "0001004000400030",
    "0001004040000030",
    "0001004040300000",
    "0001004004300000",
    "0001004004000030"
  ]
}
