{
  "puzzle_info": {
    "grid_width": 4,
    "grid_height": 4,
    "steps_to_solve": 13
  },
  "solution_path": [
    "0000300040004400",
    "0000300000044400",
    "0000300000004404",
    "0000300000004440",
    "0400300000004040",
    "0400300000000440",
    "0400000000003440",
    "0400040000003040",
    "0400040000000340",
    "0400040003000040",
    "0400000403000040",
    "0000040403000040",
    "0000044003000040",
    "0000404003000040"
  ]
}
