{
  "puzzle_info": {
    "grid_width": 5,
    "grid_height": 5,
    "steps_to_solve": 19
  },
  "solution_path": [
    "2100401000000000400000000",
    "0100401000000000400020000",
    "0100001000000000400020004",
    "0100001000000000000024004",
    "0100001000000000000020044",
    "0104001000000000000020004",
    "0104001000000000000000024",
    "0104001020000000000000004",
    "0140001020000000000000004",
    "0100001020000000000000404",
    "0100001020000000000040004",
    "0100001020000000000044000",
    "4100001020000000000004000",
    "4100001020040000000000000",
    "4100001020400000000000000",
    "0100041020400000000000000",
    "0100041020000040000000000",
    "0100441020000000000000000",
    "0140041020000000000000000",
    "0100041020000000000000400"
  ]
}
