{
  "puzzle_info": {
    "grid_width": 5,
    "grid_height": 5,
    "steps_to_solve": 19
  },
  "solution_path": [
    "0000000031024010000002000",
    "0000000031204010000002000",
    "0000000031240010000002000",
    "2000000031040010000002000",
    "2000000031000010400002000",
    "2000000031000010400020000",
    "2000020031000010400000000",
    "2000000231000010400000000",
    "2003000201000010400000000",
    "2300000201000010400000000",
    "0300000201000010400020000",
    "0000000201030010400020000",
    "0000000201030010400000002",
    "0000000201030010400200000",
    "0000000201030010420000000",
    "0000000201030010020004000",
    "0000000201030010020000004",
    "0000000201030010020400000",
    "0000000201030010024000000",
    "0000000201030012004000000"
  ]
}
