{
  "puzzle_info": {
    "grid_width": 5,
    "grid_height": 5,
    "steps_to_solve": 18
  },
  "solution_path": [
    "4000000000000010210030000",
    "0000000000000014210030000",
    "0200000000000014010030000",
    "0200000000000010410030000",
    "0200004000000010010030000",
    "2000004000000010010030000",
    "2000004000000010010000003",
    "0000004000000010010020003",
    "0000004000000010010023000",
    "2000004000000010010003000",
    "0000204000000010010003000",
    "0000004002000010010003000",
    "0000004200000010010003000",
    "0000004200030010010000000",
    "0400000200030010010000000",
    "0000400200030010010000000",
    "0000000204030010010000000",
    "0000000240030010010000000",
    "0004000200030010010000000"
  ]
}
