{
  "puzzle_info": {
    "grid_width": 4,
    "grid_height": 4,
    "steps_to_solve": 11
  },
  "solution_path": [
    "0040000000000014",
    "4000000000000014",
    "4004000000000010",
    "4400000000000010",
    "0400000000004010",
    "0400000000000410",
    "0400040000000010",
    "4000040000000010",
    "0000040000004010",
    "0000040000000410",
    "0000040004000010",
    "0000040000040010"
  ]
}
