{
  "puzzle_info": {
    "grid_width": 4,
    "grid_height": 4,
    "steps_to_solve": 10
  },
  "solution_path": [
    "0300000000000410",
    "3000000000000410",
    "0000000000003410",
    "0400000000003010",
    "0400000000000310",
    "0400030000000010",
    "4000030000000010",
    "0000030000004010",
    "0000030000000410",
    "0000030004000010",
    "0000030000040010"
  ]
}
