{
  "puzzle_info": {
    "grid_width": 4,
    "grid_height": 4,
    "steps_to_solve": 11
  },
  "solution_path": [
    "0440000000004000",
    "0040000000004400",
    "4040000000000400",
    "0440000000000400",
    "0040000004000400",
    "0004000004000400",
    "0004000004000004",
    "0000000004040004",
    "0000000004400004",
    "0000000040400004",
    "0004000040400000",
    "4000000040400000"
  ]
}
