{
  "puzzle_info": {
    "grid_width": 4,
    "grid_height": 4,
    "steps_to_solve": 13
  },
  "solution_path": [
    "0002000340000000",
    "0002000040000003",
    "0000000040020003",
    "4000000000020003",
    "4000000000023000",
    "4000300000020000",
    "0004300000020000",
    "0000300400020000",
    "0000340000020000",
    "3000040000020000",
    "0003040000020000",
    "0000040300020000",
    "0000043000020000",
    "0000003000020400"
  ]
}
