{
  "puzzle_info": {
    "grid_width": 4,
    "grid_height": 4,
    "steps_to_solve": 12
  },
  "solution_path": [
    "0000220000040000",
    "0200200000040000",
    "0002200000040000",
    "0002200400000000",
    "0002240000000000",
    "2002040000000000",
    "0022040000000000",
    "0002040000000020",
    "2000040000000020",
    "0000040000002020",
    "0000040000000220",
    "0000040002000020",
    "0000000402000020"
  ]
}
