{
  "puzzle_info": {
    "grid_width": 5,
    "grid_height": 5,
    "steps_to_solve": 17
  },
  "solution_path": [
    "2010040000000000000000000",
    "0210040000000000000000000",
    "0010040000000000000002000",
    "0010000000000000000042000",
    "0010000000000000000040002",
    "0010000000000000000000042",
    "0010200000000000000000040",
    "0012000000000000000000040",
    "0010000000000000002000040",
    "0010000000000000002000004",
    "0010400000000000002000000",
    "0014000000000000002000000",
    "0010000000000400002000000",
    "0010000000000400000200000",
    "0010200000000400000000000",
    "0012000000000400000000000",
    "0010000020000400000000000",
    "0010000020000040000000000"
  ]
}
