{
  "puzzle_info": {
    "grid_width": 4,
    "grid_height": 4,
    "steps_to_solve": 13
  },
  "solution_path": [
    "0204000000020000",
    "0004000000020200",
    "0004000200000200",
    "0004200000000200",
    "0004200000000002",
    "0000200000040002",
    "0000200000042000",
    "0000200020040000",
    "0000200000240000",
    "0000200000200004",
    "0000200000204000",
    "0000200040200000",
    "0000200004200000",
    "0000200000200400"
  ]
}
