{
  "puzzle_info": {
    "grid_width": 4,
    "grid_height": 4,
    "steps_to_solve": 13
  },
  "solution_path": [
    "0004403200000000",
    "4000403200000000",
    "4000430200000000",
    "4000030200004000",
    "4000030200000004",
    "0000030200004004",
    "0000030000024004",
    "0000030000024400",
    "4000030000020400",
    "0004030000020400",
    "0000030400020400",
    "0000034000020400",
    "0000034004020000",
    "0000304004020000"
  ]
}
