{
  "puzzle_info": {
    "grid_width": 4,
    "grid_height": 4,
    "steps_to_solve": 12
  },
  "solution_path": [
    "0024000040020000",
    "0004000040020020",
    "4004000000020020",
    "4004000200000020",
    "4400000200000020",
    "0400000200004020",
    "0400000200000420",
    "0400040200000020",
    "4000040200000020",
    "0000040200004020",
    "0000042000004020",
    "0000042000204000",
    "0000040200204000"
  ]
}
