{
  "puzzle_info": {
    "grid_width": 4,
    "grid_height": 4,
    "steps_to_solve": 14
  },
  "solution_path": [
    "0200000000040230",
    "0000000002040230",
    "0000000000240230",
    "0020000000040230",
    "0020000040000230",
    "0000000040200230",
    "0000000040202030",
    "0000000040202300",
    "0300000040202000",
    "0300000004202000",
    "0300000004200002",
    "0302000004200000",
    "0320000004200000",
    "0300002004200000",
    "0300002004000020"
  ]
}
