{
  "puzzle_info": {
    "grid_width": 4,
    "grid_height": 4,
    "steps_to_solve": 10
  },
  "solution_path": [
    "3000040000001000",
    "0000040030001000",
    "0000400030001000",
    "0000400000031000",
    "0000000040031000",
    "0000000000431000",
    "0003000000401000",
    "3000000000401000",
    "0000000030401000",
    "0000000003401000",
    "0000000003041000"
  ]
}
