{
  "puzzle_info": {
    "grid_width": 4,
    "grid_height": 4,
    "steps_to_solve": 10
  },
  "solution_path": [
    "4000000000000140",
    "0004000000000140",
    "0000000000000144",
    "0040000000000104",
    "0040000000000140",
    "0040004000000100",
    "0004004000000100",
    "0000004000000104",
    "0000004000000140",
    "0000004000400100",
    "0000004040000100"
  ]
}
