{
  "puzzle_info": {
    "grid_width": 4,
    "grid_height": 4,
    "steps_to_solve": 13
  },
  "solution_path": [
    "0040000300040000",
    "4000000300040000",
    "4000000340000000",
    "0000400340000000",
    "0000004340000000",
    "0003004040000000",
    "3000004040000000",
    "3000404000000000",
    "0003404000000000",
    "0000404000000003",
    "0000404000003000",
    "0000404030000000",
    "0000044030000000",
    "0000004030000400"
  ]
}
