{
  "puzzle_info": {
    "grid_width": 4,
    "grid_height": 4,
    "steps_to_solve": 13
  },
  "solution_path": [
    "0020040000304000",
    "2000040000304000",
    "0000040020304000",
    "0000000420304000",
    "0000000423004000",
    "0000000423000004",
    "0000000023040004",
    "0000000023400004",
    "0300000020400004",
    "0300000002400004",
    "0304000002400000",
    "0340000002400000",
    "0300004002400000",
    "0300004002000040"
  ]
}
