{
  "puzzle_info": {
    "grid_width": 4,
    "grid_height": 4,
    "steps_to_solve": 13
  },
  "solution_path": [
    "0003400000023000",
    "0000400300023000",
    "0000430000023000",
    "0300400000023000",
    "0300400030020000",
    "0300400000320000",
    "0302400000300000",
    "0320400000300000",
    "0020400000300300",
    "0000402000300300",
    "0000042000300300",
    "0000042000000330",
    "0000042003000030",
    "0400002003000030"
  ]
}
