{
  "puzzle_info": {
    "grid_width": 4,
    "grid_height": 4,
    "steps_to_solve": 13
  },
  "solution_path": [
    "0400030002000003",
    "0004030002000003",
    "0304000002000003",
    "0340000002000003",
    "0340000000000203",
    "0040000003000203",
    "0040000003000023",
    "0040002003000003",
    "0040000203000003",
    "0040000203030000",
    "0040200003030000",
    "0040200003300000",
    "0000204003300000",
    "0000204003000030"
  ]
}
