{
  "puzzle_info": {
    "grid_width": 4,
    "grid_height": 4,
    "steps_to_solve": 10
  },
  "solution_path": [
    "0000000000103002",
    "3000000000100002",
    "0003000000100002",
    "0003000200100000",
    "3000000200100000",
    "0000000200103000",
    "0000200000103000",
    "0000200030100000",
    "0000000230100000",
    "0000000203100000",
    "0000000200100300"
  ]
}
