{
  "puzzle_info": {
    "grid_width": 4,
    "grid_height": 4,
    "steps_to_solve": 11
  },
  "solution_path": [
    "0002000000002020",
    "0002000000002002",
    "0002000200002000",
    "0002200000002000",
    "0002200020000000",
    "0002200000020000",
    "0000200200020000",
    "0000220000020000",
    "2000020000020000",
    "0002020000020000",
    "0000020200020000",
    "0000022000020000"
  ]
}
