{
  "puzzle_info": {
    "grid_width": 4,
    "grid_height": 4,
    "steps_to_solve": 12
  },
  "solution_path": [
    "0020000000000303",
    "0020000000000033",
    "0020003000000003",
    "0020003000003000",
    "3020003000000000",
    "3200003000000000",
    "0200003000003000",
    "0200003000000003",
    "0000003000000203",
    "0000003000000230",
    "0200003000000030",
    "0200003000300000",
    "0200003030000000"
  ]
}
