{
  "puzzle_info": {
    "grid_width": 5,
    "grid_height": 5,
    "steps_to_solve": 19
  },
  "solution_path": [
    "2000100100000002004000300",
    "0000100100200002004000300",
    "0000100100200000004020300",
    "0000100100200000000020340",
    "0000100100200000000002340",
    "0000100100203000000002040",
    "0000100100023000000002040",
    "0000100100020030000002040",
    "0000100103020000000002040",
    "0000100130020000000002040",
    "0000100100020000003002040",
    "0000100100020000203000040",
    "0000100100020000203040000",
    "4000100100020000203000000",
    "0004100100020000203000000",
    "0204100100000000203000000",
    "0240100100000000203000000",
    "0040100100020000203000000",
    "0040100100020000023000000",
    "0040100100020000020300000"
  ]
}
