{
  "puzzle_info": {
    "grid_width": 5,
    "grid_height": 5,
    "steps_to_solve": 18
  },
  "solution_path": [
    "0000000011004040000340000",
    "0000000011000040000340400",
    "0000000011400000000340400",
    "0000000011400004000300400",
    "0000000011400000004300400",
    "0000000011400030004000400",
    "0000000011430000004000400",
    "0000000011030000004040400",
    "0000000011030000004004400",
    "0000000011000000304004400",
    "0000000011000000304040400",
    "4000000011000000304000400",
    "0000400011000000304000400",
    "0040400011000000304000000",
    "0044000011000000304000000",
    "0004000011000000304000400",
    "0004000011000000304000004",
    "0004000011000040304000000",
    "0004000011400000304000000"
  ]
}
