{
  "puzzle_info": {
    "grid_width": 4,
    "grid_height": 4,
    "steps_to_solve": 13
  },
  "solution_path": [
    "2100000000010440",
    "2100040000010040",
    "2100400000010040",
    "2100400000014000",
    "2100000040014000",
    "0100200040014000",
    "0100200000414000",
    "0100200040410000",
    "0100000240410000",
    "0102000040410000",
    "0120000040410000",
    "0100002040410000",
    "0100002044010000",
    "4100002004010000"
  ]
}
