{
  "puzzle_info": {
    "grid_width": 5,
    "grid_height": 5,
    "steps_to_solve": 20
  },
  "solution_path": [
    "0200100000000000440000300",
    "0200104000000000040000300",
    "2000104000000000040000300",
    "0000104000000000040020300",
    "0000104000000000040023000",
    "0000104000030000040020000",
    "0000104000300000040020000",
    "0000104000000003040020000",
    "0000104000000000340020000",
    "0040104000000000300020000",
    "0004104000000000300020000",
    "0000104000000000300020040",
    "2000104000000000300000040",
    "0002104000000000300000040",
    "0000104000000000302000040",
    "0000104000000000302000004",
    "0000104004000000302000000",
    "0000104400000000302000000",
    "0000100400040000302000000",
    "0000100400040000032000000",
    "0000100400040000030200000"
  ]
}
