{
  "puzzle_info": {
    "grid_width": 4,
    "grid_height": 4,
    "steps_to_solve": 12
  },
  "solution_path": [
    "0120000040000000",
    "0100000040000020",
    "0100000000004020",
    "0100000000004002",
    "0100000000000042",
    "0102000000000040",
    "0120000000000040",
    "0100000000200040",
    "0100000000200004",
    "0104000000200000",
    "0140000000200000",
    "0100004000200000",
    "0100004000020000"
  ]
}
