{
  "puzzle_info": {
    "grid_width": 4,
    "grid_height": 4,
    "steps_to_solve": 14
  },
  "solution_path": [
    "0031000000000002",
    "0001000000000032",
    "0001000000003002",
    "0001000000003200",
    "3001000000000200",
    "3201000000000000",
    "3021000000000000",
    "3001000000000020",
    "0031000000000020",
    "0001000000300020",
    "0001000000302000",
    "2001000000300000",
    "0021000000300000",
    "0001002000300000",
    "0001002030000000"
  ]
}
