{
  "puzzle_info": {
    "grid_width": 4,
    "grid_height": 4,
    "steps_to_solve": 11
  },
  "solution_path": [
    "0020230000000200",
    "2000230000000200",
    "2000200300000200",
    "2000200000000203",
    "2000000200000203",
    "2000000000020203",
    "2000000000020230",
    "2030000000020200",
    "0230000000020200",
    "0030000002020200",
    "0030000002200200",
    "0030000020200200"
  ]
}
