{
  "puzzle_info": {
    "grid_width": 4,
    "grid_height": 4,
    "steps_to_solve": 12
  },
  "solution_path": [
    "0000002030000202",
    "3000002000000202",
    "3000002000000022",
    "3000000000200022",
    "3002000000200020",
    "0032000000200020",
    "0002003000200020",
    "2000003000200020",
    "2000003020000020",
    "0000203020000020",
    "0000023020000020",
    "0000023020200000",
    "0000020320200000"
  ]
}
