{
  "puzzle_info": {
    "grid_width": 4,
    "grid_height": 4,
    "steps_to_solve": 11
  },
  "solution_path": [
    "0000000100004003",
    "4000000100000003",
    "4000000100003000",
    "0000000140003000",
    "0000000140000003",
    "0000000140030000",
    "0000000143000000",
    "0000000103004000",
    "0000000103000004",
    "0000000103040000",
    "0000000103400000",
    "0040000103000000"
  ]
}
