{
  "puzzle_info": {
    "grid_width": 4,
    "grid_height": 4,
    "steps_to_solve": 13
  },
  "solution_path": [
    "0020000040000003",
    "0000000040000023",
    "0003000040000020",
    "0003000040000002",
    "0000000040030002",
    "0000000043000002",
    "0000000003004002",
    "0000000003000042",
    "0040000003000002",
    "0040000003002000",
    "2040000003000000",
    "0240000003000000",
    "0040020003000000",
    "0040020030000000"
  ]
}
