{
  "puzzle_info": {
    "grid_width": 5,
    "grid_height": 5,
    "steps_to_solve": 18
  },
  "solution_path": [
    "0000003001000040020004000",
    "0000003001000000020004004",
    "0020003001000000000004004",
    "0020003001000000000004400",
    "0020003001040000000000400",
    "0020000031040000000000400",
    "0020000001040000000000430",
    "0020000001040000000000403",
    "0020000001040030000000400",
    "0020000001043000000000400",
    "0000000201043000000000400",
    "0400000201003000000000400",
    "4000000201003000000000400",
    "4000000201003000040000000",
    "4000000201300000040000000",
    "0000040201300000040000000",
    "0000004201300000040000000",
    "0000004021300000040000000",
    "0000004021000030040000000"
  ]
}
