{
  "puzzle_info": {
    "grid_width": 4,
    "grid_height": 4,
    "steps_to_solve": 13
  },
  "solution_path": [
    "0030200000000003",
    "0000200000000033",
    "2000000000000033",
    "2003000000000030",
    "0023000000000030",
    "0023003000000000",
    "2003003000000000",
    "2300003000000000",
    "0300003000002000",
    "0300003000000002",
    "0000003000000302",
    "0000003000000320",
    "0000003000200300",
    "0000003020000300"
  ]
}
