{
  "puzzle_info": {
    "grid_width": 5,
    "grid_height": 5,
    "steps_to_solve": 16
  },
  "solution_path": [
    "0020000000003020200000000",
    "0000000200003020200000000",
    "0000000200300020200000000",
    "3000000200000020200000000",
    "3000000200200000200000000",
    "0000030200200000200000000",
    "0000003200200000200000000",
    "0000003200000020200000000",
    "0000003200020020000000000",
    "0300000200020020000000000",
    "0000300200020020000000000",
    "0000000203020020000000000",
    "0000000230020020000000000",
    "0000000030020020000000200",
    "0000000030022000000000200",
    "0000000030022000020000000",
    "0000000030020020020000000"
  ]
}
