{
  "puzzle_info": {
    "grid_width": 5,
    "grid_height": 5,
    "steps_to_solve": 16
  },
  "solution_path": [
    "2000143000001000000000000",
    "2000140000001000000003000",
    "2000100004001000000003000",
    "0000100004001000000023000",
    "0000100004001000000020003",
    "0000100004001030000020000",
    "0000140000001030000020000",
    "0000100000001034000020000",
    "0000100000001034000000002",
    "0000100000001034000200000",
    "0000100000001034200000000",
    "4000100000001030200000000",
    "0004100000001030200000000",
    "0000100000001030200000040",
    "0000100000001300200000040",
    "0000100000001300204000000",
    "0000100000001030204000000"
  ]
}
