{
  "puzzle_info": {
    "grid_width": 4,
    "grid_height": 4,
    "steps_to_solve": 13
  },
  "solution_path": [
    "0000000300000044",
    "0003000000000044",
    "0003000000004004",
    "0003000400004000",
    "0003400000004000",
    "0000400000004003",
    "0000400040000003",
    "0000000440000003",
    "0000000440030000",
    "0000000443000000",
    "0000000403004000",
    "0000000403000004",
    "0000000403040000",
    "0000000403400000"
  ]
}
