{
  "puzzle_info": {
    "grid_width": 4,
    "grid_height": 4,
    "steps_to_solve": 13
  },
  "solution_path": [
    "0000003000200004",
    "0000300000200004",
    "0000300000204000",
    "0000000030204000",
    "0000000003204000",
    "0020000003004000",
    "4020000003000000",
    "4200000003000000",
    "0200000003004000",
    "0200000003000004",
    "0204000003000000",
    "0240000003000000",
    "0040020003000000",
    "0040020000030000"
  ]
}
