{
  "puzzle_info": {
    "grid_width": 5,
    "grid_height": 5,
    "steps_to_solve": 18
  },
  "solution_path": [
    "0420003000002000000000000",
    "4020003000002000000000000",
    "4000203000002000000000000",
    "4300200000002000000000000",
    "4003200000002000000000000",
    "0043200000002000000000000",
    "0040200000002000000000030",
    "0042000000002000000000030",
    "0040000000002000002000030",
    "0040000000002000002000003",
    "0040300000002000002000000",
    "0043000000002000002000000",
    "0003000400002000002000000",
    "0000000400002300002000000",
    "0000000400000300002000200",
    "0000000400300000002000200",
    "0000000400302000002000000",
    "0000000400032000002000000",
    "0000000400030020002000000"
  ]
}
