{
  "puzzle_info": {
    "grid_width": 5,
    "grid_height": 5,
    "steps_to_solve": 17
  },
  "solution_path": [
    "0004010300002000000000000",
    "0000010300002000000000040",
    "0000010300000020000000040",
    "0000010000000020000000340",
    "0000010000000020000030040",
    "0000010000300020000000040",
    "0000010000000320000000040",
    "0000010000000320000040000",
    "0000010000400320000000000",
    "0000010000004320000000000",
    "0003010000004020000000000",
    "0003010000004200000000000",
    "0003010000004000000000020",
    "0000010000004000003000020",
    "0000010000004000003020000",
    "0000010000204000003000000",
    "0000010000024000003000000",
    "0000010000020000003000400"
  ]
}
