{
  "puzzle_info": {
    "grid_width": 4,
    "grid_height": 4,
    "steps_to_solve": 12
  },
  "solution_path": [
    "0000220002300000",
    "2000020002300000",
    "0002020002300000",
    "0202000002300000",
    "0202000002030000",
    "0202000000230000",
    "0202000300200000",
    "0220000300200000",
    "0020000300200200",
    "0020300000200200",
    "0000302000200200",
    "0000032000200200",
    "0020030000200200"
  ]
}
