{
  "puzzle_info": {
    "grid_width": 4,
    "grid_height": 4,
    "steps_to_solve": 13
  },
  "solution_path": [
    "4000400000300002",
    "4000000400300002",
    "4000000400302000",
    "0000000440302000",
    "0000000443002000",
    "0000000443000002",
    "0000000443020000",
    "0000000443200000",
    "0300000440200000",
    "0300000404200000",
    "0000030404200000",
    "0000034004200000",
    "0000304004200000",
    "0000304004000020"
  ]
}
