{
  "puzzle_info": {
    "grid_width": 4,
    "grid_height": 4,
    "steps_to_solve": 12
  },
  "solution_path": [
    "0002200000000003",
    "2002000000000003",
    "2200000000000003",
    "0200000000002003",
    "0000000000002203",
    "0000000000002230",
    "0200000000002030",
    "0200000000000230",
    "0200020000000030",
    "2000020000000030",
    "0000020000002030",
    "0000020000000230",
    "0030020000000200"
  ]
}
