{
  "puzzle_info": {
    "grid_width": 5,
    "grid_height": 5,
    "steps_to_solve": 19
  },
  "solution_path": [
    "0024004010000000000001020",
    "2004004010000000000001020",
    "2400004010000000000001020",
    "2400000010000000400001020",
    "2000000010040000400001020",
    "2000000010040000400001200",
    "2020000010040000400001000",
    "0220000010040000400001000",
    "0020002010040000400001000",
    "0000202010040000400001000",
    "0000202010000040400001000",
    "0000002012000040400001000",
    "0000002012040040000001000",
    "0000002012044000000001000",
    "0000002012004000400001000",
    "0000002012004000000401000",
    "0000002012004000000001004",
    "0000002012004000000001400",
    "0000002012004000040001000",
    "0040002012000000040001000"
  ]
}
