{
  "puzzle_info": {
    "grid_width": 4,
    "grid_height": 4,
    "steps_to_solve": 14
  },
  "solution_path": [
    "4002000030000300",
    "0042000030000300",
    "3042000000000300",
    "3402000000000300",
    "3002000004000300",
    "0032000004000300",
    "0030000004000302",
    "0030000004000032",
    "0030003004000002",
    "0030000304000002",
    "0030000304020000",
    "0030300004020000",
    "0030300004200000",
    "0000303004200000",
    "0000303004020000"
  ]
}
