{
  "puzzle_info": {
    "grid_width": 4,
    "grid_height": 4,
    "steps_to_solve": 11
  },
  "solution_path": [
    "4001010000020004",
    "4001010020000004",
    "4001210000000004",
    "0041210000000004",
    "0001210000000044",
    "0001210000004004",
    "0001210000004400",
    "0001210040000400",
    "0001210000040400",
    "0001210004040000",
    "0001210004400000",
    "0001210000400400"
  ]
}
