{
  "puzzle_info": {
    "grid_width": 4,
    "grid_height": 4,
    "steps_to_solve": 15
  },
  "solution_path": [
    "1000000001024320",
    "1002000001004320",
    "1002400001000320",
    "1022400001000300",
    "1022400001000003",
    "1002400001000023",
    "1002400001002003",
    "1002400021000003",
    "1002000421000003",
    "1002000021040003",
    "1000000221040003",
    "1000000221400003",
    "1000000221430000",
    "1002000021430000",
    "1200000021430000",
    "1000020021430000"
  ]
}
