{
  "puzzle_info": {
    "grid_width": 5,
    "grid_height": 5,
    "steps_to_solve": 9
  },
  "solution_path": [
    "0000000000000000000033000",
    "3000000000000000000003000",
    "3000000000000000000030000",
    "0000000000000003000030000",
    "0000000000000000000330000",
    "3000000000000000000300000",
    "0000300000000000000300000",
    "0000000000000030000300000",
    "0000000000000033000000000",
    "3000000000000030000000000"
  ]
}
