{
  "puzzle_info": {
    "grid_width": 4,
    "grid_height": 4,
    "steps_to_solve": 11
  },
  "solution_path": [
    "0220000000020000",
    "0020000000020200",
    "0002000000020200",
    "0000000200020200",
    "0000000220000200",
    "0000000220000002",
    "0000000220020000",
    "0000000222000000",
    "0000000202002000",
    "0000000202000002",
    "0000000202020000",
    "0000200002020000"
  ]
}
