{
  "puzzle_info": {
    "grid_width": 4,
    "grid_height": 4,
    "steps_to_solve": 12
  },
  "solution_path": [
    "0000000100040003",
    "0000000140000003",
    "0000000100004003",
    "0000000100034000",
    "0000000130004000",
    "0000000130000004",
    "0000000130040000",
    "0000000134000000",
    "0000000104003000",
    "0000000104000003",
    "0000000104030000",
    "0000000104300000",
    "0000000140300000"
  ]
}
