{
  "puzzle_info": {
    "grid_width": 4,
    "grid_height": 4,
    "steps_to_solve": 12
  },
  "solution_path": [
    "0002400200020000",
    "2000400200020000",
    "2000420000020000",
    "2000020000024000",
    "2000020000020004",
    "0000020000022004",
    "0000020000022400",
    "2000020000020400",
    "0002020000020400",
    "0000020200020400",
    "0000020204020000",
    "0000020204200000",
    "0000020200200400"
  ]
}
