{
  "puzzle_info": {
    "grid_width": 4,
    "grid_height": 4,
    "steps_to_solve": 13
  },
  "solution_path": [
    "0020000300300400",
    "2000000300300400",
    "0000000300302400",
    "0000000000302403",
    "0000000000302043",
    "0000000000300243",
    "0200000000300043",
    "0203000000300040",
    "0230000000300040",
    "0200003000300040",
    "0200003030000040",
    "0200003030400000",
    "0200003003400000",
    "0200003003000040"
  ]
}
