{
  "puzzle_info": {
    "grid_width": 4,
    "grid_height": 4,
    "steps_to_solve": 12
  },
  "solution_path": [
    "0000000030300002",
    "3000000000300002",
    "3000000030000002",
    "3000300000000002",
    "3000000300000002",
    "3000000300020000",
    "3000000320000000",
    "0000300320000000",
    "0000003320000000",
    "0003003020000000",
    "3000003020000000",
    "0000303020000000",
    "0000033020000000"
  ]
}
