{
  "puzzle_info": {
    "grid_width": 4,
    "grid_height": 4,
    "steps_to_solve": 12
  },
  "solution_path": [
    "0200000400000404",
    "0000000402000404",
    "0000000402040400",
    "0000000402400400",
    "0000000420400400",
    "0400000420400000",
    "0400000402400000",
    "0400020400400000",
    "0400024000400000",
    "0400204000400000",
    "0000204000400400",
    "0000024000400400",
    "0040020000400400"
  ]
}
