{
  "puzzle_info": {
    "grid_width": 4,
    "grid_height": 4,
    "steps_to_solve": 13
  },
  "solution_path": [
    "0013200000000000",
    "0010200000000003",
    "2010000000000003",
    "0210000000000003",
    "0210000000003000",
    "0010000000003200",
    "3010000000000200",
    "0310000000000200",
    "0010000003000200",
    "0010000003002000",
    "2010000003000000",
    "0210000003000000",
    "0010020003000000",
    "0010020000030000"
  ]
}
