{
  "puzzle_info": {
    "grid_width": 4,
    "grid_height": 4,
    "steps_to_solve": 13
  },
  "solution_path": [
    "0024000000300000",
    "2004000000300000",
    "2034000000000000",
    "2304000000000000",
    "2340000000000000",
    "2040000000000300",
    "0240000000000300",
    "0040000002000300",
    "0040000002003000",
    "3040000002000000",
    "0340000002000000",
    "0040030002000000",
    "0000030002000040",
    "0000030000020040"
  ]
}
