{
  "puzzle_info": {
    "grid_width": 4,
    "grid_height": 4,
    "steps_to_solve": 13
  },
  "solution_path": [
    "0000020000000043",
    "0000020000004003",
    "0000000000004203",
    "0000000000004023",
    "0020000000004003",
    "0020000000004300",
    "4020000000000300",
    "0420000000000300",
    "0020000004000300",
    "0020000004003000",
    "3020000004000000",
    "0320000004000000",
    "0020030004000000",
    "0020000304000000"
  ]
}
