{
  "puzzle_info": {
    "grid_width": 4,
    "grid_height": 4,
    "steps_to_solve": 13
  },
  "solution_path": [
    "0300000030000402",
    "0003000030000402",
    "3003000000000402",
    "3003000000000420",
    "3403000000000020",
    "3043000000000020",
    "0343000000000020",
    "0303000000400020",
    "0330000000400020",
    "0300003000400020",
    "0300003040000020",
    "0300003040200000",
    "0300003004200000",
    "0300003004020000"
  ]
}
