{
  "puzzle_info": {
    "grid_width": 5,
    "grid_height": 5,
    "steps_to_solve": 19
  },
  "solution_path": [
    "0000400040020010200100000",
    "4000000040020010200100000",
    "4000000000020010200100040",
    "4000000000020010000102040",
    "4000000000020010000100240",
    "4004000000020010000100200",
    "0044000000020010000100200",
    "0004000000020010040100200",
    "0004000000020010040120000",
    "2004000000020010040100000",
    "2400000000020010040100000",
    "2000004000020010040100000",
    "0000204000020010040100000",
    "0000004002020010040100000",
    "0000004200020010040100000",
    "0400000200020010040100000",
    "0000400200020010040100000",
    "0000000204020010040100000",
    "0000000240020010040100000",
    "0000020040020010040100000"
  ]
}
