{
  "puzzle_info": {
    "grid_width": 5,
    "grid_height": 5,
    "steps_to_solve": 15
  },
  "solution_path": [
    "0000200000420000000000000",
    "2000000000420000000000000",
    "0000020000420000000000000",
    "0000020000400000000002000",
    "0000020000000040000002000",
    "0000020000000040000020000",
    "0000020000200040000000000",
    "0000020000000240000000000",
    "0000020000000200000000004",
    "0000020000000200000040000",
    "0000020000400200000000000",
    "2000000000400200000000000",
    "2000000000004200000000000",
    "2040000000000200000000000",
    "0240000000000200000000000",
    "0200000000000200000000400"
  ]
}
