{
  "puzzle_info": {
    "grid_width": 4,
    "grid_height": 4,
    "steps_to_solve": 13
  },
  "solution_path": [
    "4000000000002034",
    "4030000000002004",
    "0430000000002004",
    "0430000000000024",
    "0400000000300024",
    "0404000000300020",
    "0440000000300020",
    "0040000000300420",
    "0040003000000420",
    "0040003000200400",
    "0040300000200400",
    "0000304000200400",
    "0000034000200400",
    "0040030000200400"
  ]
}
