{
  "puzzle_info": {
    "grid_width": 5,
    "grid_height": 5,
    "steps_to_solve": 16
  },
  "solution_path": [
    "0000000100030000004000013",
    "0300000100000000004000013",
    "0300000100000004000000013",
    "4300000100000000000000013",
    "4300300100000000000000010",
    "4330000100000000000000010",
    "4030000100000000000003010",
    "0430000100000000000003010",
    "0030000100000000400003010",
    "0030000100000000400000310",
    "0030000100003000400000010",
    "0030000100000030400000010",
    "0030300100000000400000010",
    "0033000100000000400000010",
    "0030000100000000403000010",
    "0030000100000000430000010",
    "0030000100000004030000010"
  ]
}
