{
  "puzzle_info": {
    "grid_width": 4,
    "grid_height": 4,
    "steps_to_solve": 11
  },
  "solution_path": [
    "0033300000000000",
    "0030300000000003",
    "0030000000003003",
    "0030000000003300",
    "3030000000000300",
    "0330000000000300",
    "0030000003000300",
    "0030000003003000",
    "3030000003000000",
    "0330000003000000",
    "0030030003000000",
    "0030000303000000"
  ]
}
