{
  "puzzle_info": {
    "grid_width": 4,
    "grid_height": 4,
    "steps_to_solve": 13
  },
  "solution_path": [
    "1000040000003000",
    "1000040000000003",
    "1003040000000000",
    "1300040000000000",
    "1300000400000000",
    "1000000400000300",
    "1004000000000300",
    "1400000000000300",
    "1000000004000300",
    "1000000004000003",
    "1003000004000000",
    "1300000004000000",
    "1000030004000000",
    "1000030000040000"
  ]
}
