{
  "puzzle_info": {
    "grid_width": 4,
    "grid_height": 4,
    "steps_to_solve": 13
  },
  "solution_path": [
    "4000003000000200",
    "4000300000000200",
    "4000300000002000",
    "4000000030002000",
    "0000400030002000",
    "0000400000032000",
    "0000400020030000",
    "0000000420030000",
    "0000000423000000",
    "0000000403002000",
    "0000000403000002",
    "0000000403020000",
    "0000000403200000",
    "0000000400200300"
  ]
}
