{
  "puzzle_info": {
    "grid_width": 4,
    "grid_height": 4,
    "steps_to_solve": 11
  },
  "solution_path": [
    "0230000003000000",
    "0200000003000030",
    "0200030000000030",
    "2000030000000030",
    "2000030000003000",
    "0000030020003000",
    "0000030000023000",
    "3000030000020000",
    "0003030000020000",
    "0000030300020000",
    "0000033000020000",
    "0000033020000000"
  ]
}
