{
  "puzzle_info": {
    "grid_width": 4,
    "grid_height": 4,
    "steps_to_solve": 13
  },
  "solution_path": [
    "3000000010033200",
    "3003000010003200",
    "3003000010003002",
    "3003000010000032",
    "3003000210000030",
    "3300000210000030",
    "0300300210000030",
    "0300003210000030",
    "0302003010000030",
    "0320003010000030",
    "3020003010000030",
    "0020303010000030",
    "0020033010000030",
    "0020033010300000"
  ]
}
