{
  "puzzle_info": {
    "grid_width": 4,
    "grid_height": 4,
    "steps_to_solve": 13
  },
  "solution_path": [
    "1200000004001002",
    "1000020004001002",
    "1002020004001000",
    "1002020000041000",
    "1000020200041000",
    "1000022000041000",
    "1000202000041000",
    "1000002020041000",
    "1000002000241000",
    "1000002000041020",
    "1000002040001020",
    "1000002040201000",
    "1000002004201000",
    "1000002004021000"
  ]
}
