{
  "puzzle_info": {
    "grid_width": 4,
    "grid_height": 4,
    "steps_to_solve": 11
  },
  "solution_path": [
    "3010300000030000",
    "0310300000030000",
    "0010300000030300",
    "3010000000030300",
    "0310000000030300",
    "0010000003030300",
    "0010000003033000",
    "3010000003030000",
    "0310000003030000",
    "0010030003030000",
    "0010030000330000",
    "0013030000300000"
  ]
}
