{
  "puzzle_info": {
    "grid_width": 4,
    "grid_height": 4,
    "steps_to_solve": 13
  },
  "solution_path": [
    "3240000000000003",
    "3040000000000203",
    "0340000000000203",
    "0340000000000023",
    "0300000000400023",
    "0303000000400020",
    "0330000000400020",
    "0300003000400020",
    "0300003040000020",
    "0300003040200000",
    "0300000340200000",
    "0300000304200000",
    "0000030304200000",
    "0000030300200400"
  ]
}
