{
  "puzzle_info": {
    "grid_width": 4,
    "grid_height": 4,
    "steps_to_solve": 11
  },
  "solution_path": [
    "0000440340000000",
    "0000404340000000",
    "0000044340000000",
    "0000044040000003",
    "0000044000004003",
    "0000044000000043",
    "0000044000400003",
    "0000044000403000",
    "0000044000003040",
    "0000044000000340",
    "0000044000400300",
    "0040040000400300"
  ]
}
