{
  "puzzle_info": {
    "grid_width": 5,
    "grid_height": 5,
    "steps_to_solve": 17
  },
  "solution_path": [
    "0020000000000030000100400",
    "0000200000000030000100400",
    "0000200000300000000100400",
    "0000000000300020000100400",
    "0000000000320000000100400",
    "0000000000020000000130400",
    "0000000000020000000134000",
    "3000000000020000000104000",
    "0000300000020000000104000",
    "0000000000020030000104000",
    "0000000000023000000104000",
    "0000000000003000200104000",
    "0000000000003000200140000",
    "4000000000003000200100000",
    "0000400000003000200100000",
    "0000000000003040200100000",
    "0000000000003400200100000",
    "0000000000000400200100300"
  ]
}
