{
  "puzzle_info": {
    "grid_width": 5,
    "grid_height": 5,
    "steps_to_solve": 17
  },
  "solution_path": [
    "0000000000020240000030000",
    "0000000000020040000030020",
    "0000000000024000000030020",
    "0040000000020000000030020",
    "0040000000020000000032000",
    "0040000000000000200032000",
    "3040000000000000200002000",
    "0340000000000000200002000",
    "0040000000030000200002000",
    "0040000000030000000202000",
    "0040000000030000200200000",
    "0040000000030000002200000",
    "0040200000030000002000000",
    "0042000000030000002000000",
    "0040000000030200002000000",
    "0040000000032000002000000",
    "0000000400032000002000000",
    "0000000400030020002000000"
  ]
}
