{
  "puzzle_info": {
    "grid_width": 4,
    "grid_height": 4,
    "steps_to_solve": 12
  },
  "solution_path": [
    "0003300000200000",
    "0003300000020000",
    "0000300300020000",
    "0000003300020000",
    "0000003300000002",
    "0000003000030002",
    "0000003030000002",
    "0002003030000000",
    "2000003030000000",
    "0000203030000000",
    "0000023030000000",
    "0000003030000200",
    "0000003000030200"
  ]
}
