{
  "puzzle_info": {
    "grid_width": 4,
    "grid_height": 4,
    "steps_to_solve": 12
  },
  "solution_path": [
    "0000000002300001",
    "0000000000300201",
    "0000000030000201",
    "0000000000003201",
    "0000000000003021",
    "0020000000003001",
    "0020000000000031",
    "0020003000000001",
    "2000003000000001",
    "0000003000002001",
    "0000003000000021",
    "0000003000200001",
    "0000000300200001"
  ]
}
