{
  "puzzle_info": {
    "grid_width": 5,
    "grid_height": 5,
    "steps_to_solve": 18
  },
  "solution_path": [
    "0000000040000400020030000",
    "0000000040000000020030040",
    "0000000040000000000030240",
    "0000000040000000000032040",
    "0000000040000000000032400",
    "0200000040000000000030400",
    "0200000040000000000003400",
    "0200003040000000000000400",
    "0000203040000000000000400",
    "0000003040000000000000402",
    "0000003040000000000000420",
    "0000003040000200000000400",
    "0000003400000200000000400",
    "0000003400004200000000000",
    "0000003400400200000000000",
    "0000003000400200000000400",
    "0000003000004200000000400",
    "0000003000004200040000000",
    "0000003000400200040000000"
  ]
}
