{
  "puzzle_info": {
    "grid_width": 4,
    "grid_height": 4,
    "steps_to_solve": 13
  },
  "solution_path": [
    "0031400000000000",
    "0001400000000030",
    "0001000000004030",
    "0001000000004003",
    "0001000300004000",
    "0001300000004000",
    "0001300000000004",
    "0001300400000000",
    "0001340000000000",
    "0001040000003000",
    "0001040000000003",
    "0001040300000000",
    "0001043000000000",
    "0001403000000000"
  ]
}
