{
  "puzzle_info": {
    "grid_width": 4,
    "grid_height": 4,
    "steps_to_solve": 14
  },
  "solution_path": [
    "1300000321002000",
    "1000030321002000",
    "1000300321002000",
    "1000300321000002",
    "1000300301002002",
    "1000300301000022",
    "1000000301003022",
    "1000000301023020",
    "1000300001023020",
    "1000000031023020",
    "1000000031020320",
    "1020000031020300",
    "1200000031020300",
    "1000020031020300",
    "1000020031200300"
  ]
}
