{
  "puzzle_info": {
    "grid_width": 4,
    "grid_height": 4,
    "steps_to_solve": 13
  },
  "solution_path": [
    "2000040004000003",
    "0000040004002003",
    "0400000004002003",
    "0403000004002000",
    "0043000004002000",
    "0040000004002003",
    "0040000004002300",
    "2040000004000300",
    "0240000004000300",
    "0040020004000300",
    "0040020000040300",
    "0040020003040000",
    "0040020003400000",
    "0040020000400300"
  ]
}
