{
  "puzzle_info": {
    "grid_width": 4,
    "grid_height": 4,
    "steps_to_solve": 12
  },
  "solution_path": [
    "0000003200002000",
    "0002003000002000",
    "2000003000002000",
    "2000203000000000",
    "0002203000000000",
    "0002230000000000",
    "2002030000000000",
    "0022030000000000",
    "0002030000000020",
    "2000030000000020",
    "0000030000002020",
    "0000030000000220",
    "0000030002000020"
  ]
}
