{
  "puzzle_info": {
    "grid_width": 4,
    "grid_height": 4,
    "steps_to_solve": 14
  },
  "solution_path": [
    "0240300040100010",
    "0040300040100210",
    "0000304040100210",
    "3000004040100210",
    "3000404000100210",
    "0003404000100210",
    "0000404000100213",
    "0000400400100213",
    "0000400400102013",
    "0000400400132010",
    "0000440000132010",
    "0000040040132010",
    "0000040040130210",
    "0000040042130010",
    "0400000042130010"
  ]
}
