{
  "puzzle_info": {
    "grid_width": 5,
    "grid_height": 5,
    "steps_to_solve": 17
  },
  "solution_path": [
    "0000000040000044000000003",
    "4000000040000040000000003",
    "4000000040400000000000003",
    "0000040040400000000000003",
    "0000000440400000000000003",
    "0000000040400000000000403",
    "0000000040400000000000430",
    "0040000040400000000000030",
    "0040000040400300000000000",
    "0040040000400300000000000",
    "0040040000004300000000000",
    "0000040400004300000000000",
    "0000004400004300000000000",
    "0000004400400300000000000",
    "0000004000400300000000400",
    "0000004000004300000000400",
    "0000004000004300040000000",
    "0000004000400300040000000"
  ]
}
