{
  "puzzle_info": {
    "grid_width": 5,
    "grid_height": 5,
    "steps_to_solve": 16
  },
  "solution_path": [
    "0000300000100000000200000",
    "3000000000100000000200000",
    "0000030000100000000200000",
    "0000230000100000000000000",
    "2000030000100000000000000",
    "2000000003100000000000000",
    "0000020003100000000000000",
    "0000000023100000000000000",
    "0000300020100000000000000",
    "3000000020100000000000000",
    "0000030020100000000000000",
    "0000000320100000000000000",
    "0002000300100000000000000",
    "2000000300100000000000000",
    "0000020300100000000000000",
    "0000002300100000000000000",
    "0000002003100000000000000"
  ]
}
