{
  "puzzle_info": {
    "grid_width": 4,
    "grid_height": 4,
    "steps_to_solve": 13
  },
  "solution_path": [
    "2004304000000000",
    "2000304000000004",
    "2000300400000004",
    "2000003400000004",
    "2000003000040004",
    "2000003040000004",
    "0000203040000004",
    "0000203000004004",
    "0000203000000044",
    "0000203000400004",
    "0000203000404000",
    "0000203040400000",
    "0000023040400000",
    "0030020040400000"
  ]
}
