{
  "puzzle_info": {
    "grid_width": 4,
    "grid_height": 4,
    "steps_to_solve": 11
  },
  "solution_path": [
    "0020020300003000",
    "0000020300003020",
    "0000002300003020",
    "3000002300000020",
    "3000002300200000",
    "3000002320000000",
    "0000302320000000",
    "0000032320000000",
    "0000030320000020",
    "0000033020000020",
    "0000033020200000",
    "0000030320200000"
  ]
}
