{
  "puzzle_info": {
    "grid_width": 4,
    "grid_height": 4,
    "steps_to_solve": 13
  },
  "solution_path": [
    "0000010000240203",
    "0000010020040203",
    "0004010020000203",
    "0004010020000023",
    "0004010320000020",
    "4000010320000020",
    "4000013020000020",
    "4000010020300020",
    "4000010020300002",
    "4002010020300000",
    "4200010020300000",
    "0200410020300000",
    "0200410002300000",
    "0200410000300200"
  ]
}
