{
  "puzzle_info": {
    "grid_width": 4,
    "grid_height": 4,
    "steps_to_solve": 12
  },
  "solution_path": [
    "0001400004000300",
    "0001400000040300",
    "0001400000043000",
    "0001000040043000",
    "0001000000443000",
    "0001000400403000",
    "0001400000403000",
    "0001400030400000",
    "4001000030400000",
    "0041000030400000",
    "0001004030400000",
    "0001004003400000",
    "0001004003040000"
  ]
}
