{
  "puzzle_info": {
    "grid_width": 4,
    "grid_height": 4,
    "steps_to_solve": 13
  },
  "solution_path": [
    "4032010000003000",
    "0032010040003000",
    "0032010000043000",
    "0032010000003004",
    "0030010000023004",
    "0030010000023400",
    "3030010000020400",
    "3300010000020400",
    "3300010020000400",
    "0300310020000400",
    "0300310000020400",
    "0300310004020000",
    "0300310004200000",
    "0300310000200400"
  ]
}
