{
  "puzzle_info": {
    "grid_width": 4,
    "grid_height": 4,
    "steps_to_solve": 11
  },
  "solution_path": [
    "0201000000000002",
    "0001000000000202",
    "0001000200000200",
    "0001200000000200",
    "0001200000000002",
    "0001200200000000",
    "0001220000000000",
    "0001020000002000",
    "0001020000000002",
    "0001020200000000",
    "0001022000000000",
    "0001202000000000"
  ]
}
