{
  "puzzle_info": {
    "grid_width": 5,
    "grid_height": 5,
    "steps_to_solve": 19
  },
  "solution_path": [
    "0000100300002010003000030",
    "0000130000002010003000030",
    "0003130000002010000000030",
    "0003130030002010000000000",
    "0003133000002010000000000",
    "0003103000002010000030000",
    "0003103000000210000030000",
    "0003103020000010000030000",
    "3000103020000010000030000",
    "0000103020000013000030000",
    "0000103020000013000000003",
    "0000103020000013000300000",
    "0000103020000013300000000",
    "0000103020000010300030000",
    "0000103020000010300000003",
    "0000103020000010300300000",
    "0000103020000010330000000",
    "0000103020030010030000000",
    "0000100320030010030000000",
    "0000100302030010030000000"
  ]
}
