{
  "puzzle_info": {
    "grid_width": 4,
    "grid_height": 4,
    "steps_to_solve": 13
  },
  "solution_path": [
    "0034000040000030",
    "0004000040300030",
    "4000000040300030",
    "4000000043000030",
    "4000400003000030",
    "4000000403000030",
    "4030000403000000",
    "4300000403000000",
    "0300000403004000",
    "0000030403004000",
    "0000030403000004",
    "0000030403040000",
    "0000030403400000",
    "0000030430400000"
  ]
}
