{
  "puzzle_info": {
    "grid_width": 4,
    "grid_height": 4,
    "steps_to_solve": 13
  },
  "solution_path": [
    "0000000200000140",
    "0002000000000140",
    "2000000000000140",
    "2040000000000100",
    "2004000000000100",
    "0024000000000100",
    "0020000000000104",
    "0020000000000140",
    "0020004000000100",
    "0002004000000100",
    "0000004000000102",
    "0000004000000120",
    "0000004000200100",
    "0000004000020100"
  ]
}
