{
  "puzzle_info": {
    "grid_width": 4,
    "grid_height": 4,
    "steps_to_solve": 10
  },
  "solution_path": [
    "0000300000020000",
    "3000000000020000",
    "0003000000020000",
    "0003000020000000",
    "2003000000000000",
    "0023000000000000",
    "0003000000000020",
    "3000000000000020",
    "0000000000003020",
    "0000000000000320",
    "0020000000000300"
  ]
}
