{
  "puzzle_info": {
    "grid_width": 4,
    "grid_height": 4,
    "steps_to_solve": 12
  },
  "solution_path": [
    "0020004010040002",
    "0002004010040002",
    "0000004210040002",
    "0000004214000002",
    "0000004210000402",
    "0000004210000042",
    "0000004210020040",
    "0000004212000040",
    "0000000212400040",
    "0000000212400004",
    "0000000212440000",
    "0002000012440000",
    "2000000012440000"
  ]
}
