{
  "puzzle_info": {
    "grid_width": 4,
    "grid_height": 4,
    "steps_to_solve": 12
  },
  "solution_path": [
    "0000000000000142",
    "0040000000000102",
    "0004000000000102",
    "0004000000000120",
    "0000000000000124",
    "0020000000000104",
    "0020000000000140",
    "0020004000000100",
    "0002004000000100",
    "0000004000000102",
    "0000004000000120",
    "0000004000200100",
    "0000004000020100"
  ]
}
