{
  "puzzle_info": {
    "grid_width": 4,
    "grid_height": 4,
    "steps_to_solve": 10
  },
  "solution_path": [
    "0000002000103100",
    "0020000000103100",
    "3020000000100100",
    "3200000000100100",
    "3000000002100100",
    "0003000002100100",
    "0203000000100100",
    "0230000000100100",
    "0030000002100100",
    "0000003002100100",
    "0000003020100100"
  ]
}
