{
  "puzzle_info": {
    "grid_width": 4,
    "grid_height": 4,
    "steps_to_solve": 13
  },
  "solution_path": [
    "0040200000002000",
    "4000200000002000",
    "4000000200002000",
    "4000000000002002",
    "4000000000000022",
    "4002000000000020",
    "4200000000000020",
    "0200000000004020",
    "0200000000000420",
    "0200040000000020",
    "2000040000000020",
    "0000040000002020",
    "0000040000000220",
    "0000040002000020"
  ]
}
