{
  "puzzle_info": {
    "grid_width": 4,
    "grid_height": 4,
    "steps_to_solve": 14
  },
  "solution_path": [
    "2203000040000000",
    "0203200040000000",
    "0023200040000000",
    "0020200040000003",
    "0020000240000003",
    "0020000240030000",
    "0020000243000000",
    "4020000203000000",
    "0420000203000000",
    "0020040203000000",
    "0000040203000020",
    "0000042003000020",
    "0000042030000020",
    "0000042030200000",
    "0000040230200000"
  ]
}
