{
  "puzzle_info": {
    "grid_width": 4,
    "grid_height": 4,
    "steps_to_solve": 10
  },
  "solution_path": [
    "1030300000300030",
    "1030000300300030",
    "1030000330000030",
    "1000000330300030",
    "1000000303300030",
    "1000000303300003",
    "1000000303330000",
    "1003000003330000",
    "1300000003330000",
    "1000030003330000",
    "1000030030330000"
  ]
}
