{
  "puzzle_info": {
    "grid_width": 4,
    "grid_height": 4,
    "steps_to_solve": 13
  },
  "solution_path": [
    "0040000000000201",
    "4000000000000201",
    "4200000000000001",
    "4002000000000001",
    "4000000000020001",
    "0004000000020001",
    "0004000020000001",
    "0000000020040001",
    "0000000024000001",
    "2000000004000001",
    "0002000004000001",
    "0000000004020001",
    "0000000004200001",
    "0000000040200001"
  ]
}
