{
  "puzzle_info": {
    "grid_width": 4,
    "grid_height": 4,
    "steps_to_solve": 14
  },
  "solution_path": [
    "0000002000410033",
    "0020000000410033",
    "0020004000010033",
    "2000004000010033",
    "0000004000012033",
    "0000004000312003",
    "0000004000312300",
    "0300004000312000",
    "3000004000312000",
    "0000004030312000",
    "0000400030312000",
    "0000400003312000",
    "0000400023310000",
    "4000000023310000",
    "0004000023310000"
  ]
}
