{
  "puzzle_info": {
    "grid_width": 4,
    "grid_height": 4,
    "steps_to_solve": 12
  },
  "solution_path": [
    "0202000040000020",
    "0022000040000020",
    "0002000040200020",
    "0002000004200020",
    "0402000000200020",
    "0420000000200020",
    "4020000000200020",
    "4000002000200020",
    "4000002020000020",
    "0000402020000020",
    "0000402020200000",
    "0000402002200000",
    "0000402002020000"
  ]
}
