{
  "puzzle_info": {
    "grid_width": 4,
    "grid_height": 4,
    "steps_to_solve": 13
  },
  "solution_path": [
    "0004000000400204",
    "0000000000440204",
    "0000000040040204",
    "0200000040040004",
    "0002000040040004",
    "0002000044000004",
    "0000000044020004",
    "0000000044200004",
    "0400000040200004",
    "0400000004200004",
    "0404000004200000",
    "0440000004200000",
    "0040040004200000",
    "0040040000200400"
  ]
}
