{
  "puzzle_info": {
    "grid_width": 4,
    "grid_height": 4,
    "steps_to_solve": 10
  },
  "solution_path": [
    "0003030000003000",
    "0000030000003003",
    "0000000300003003",
    "0000000300033000",
    "0000300000033000",
    "0000300030030000",
    "0000300000330000",
    "0000300000300003",
    "0000300000303000",
    "0000300030300000",
    "3000000030300000"
  ]
}
