{
  "puzzle_info": {
    "grid_width": 5,
    "grid_height": 5,
    "steps_to_solve": 15
  },
  "solution_path": [
    "0000104000010000000020000",
    "2000104000010000000000000",
    "0002104000010000000000000",
    "0000104000010000000000020",
    "0400100000010000000000020",
    "0004100000010000000000020",
    "0000100000010000004000020",
    "0000100000010000004020000",
    "2000100000010000004000000",
    "0002100000010000004000000",
    "0000100000010200004000000",
    "0000100000010204000000000",
    "4000100000010200000000000",
    "0004100000010200000000000",
    "0000100040010200000000000",
    "0000100040012000000000000"
  ]
}
