{
  "puzzle_info": {
    "grid_width": 4,
    "grid_height": 4,
    "steps_to_solve": 12
  },
  "solution_path": [
    "0000004200203000",
    "0000400200203000",
    "0000420000203000",
    "0200400000203000",
    "0200400000200003",
    "0203400000200000",
    "0230400000200000",
    "0030400000200200",
    "0000403000200200",
    "0000043000200200",
    "0000043000000220",
    "0000040000300220",
    "0000040000300202"
  ]
}
