{
  "puzzle_info": {
    "grid_width": 4,
    "grid_height": 4,
    "steps_to_solve": 13
  },
  "solution_path": [
    "0000002033002000",
    "0020000033002000",
    "3020000003002000",
    "0320000003002000",
    "0300000003002020",
    "0300030000002020",
    "0300030000000220",
    "0300030002000020",
    "0300000302000020",
    "0000030302000020",
    "0000033002000020",
    "0000033020000020",
    "0000033020200000",
    "0030030020200000"
  ]
}
