{
  "puzzle_info": {
    "grid_width": 5,
    "grid_height": 5,
    "steps_to_solve": 18
  },
  "solution_path": [
    "0300000400000000000000204",
    "0000000400000000000003204",
    "0000000400000000000003240",
    "0000000400002000000003040",
    "0000040000002000000003040",
    "0000040000002000000000340",
    "0000040000002000030000040",
    "0000040000002000030040000",
    "0000040000402000030000000",
    "0000000004402000030000000",
    "0000000000402000030000004",
    "0000000000042000030000004",
    "0000000000040020030000004",
    "0000000000040020030400000",
    "0000000000040020034000000",
    "0030000000040020004000000",
    "0030000000042000004000000",
    "0000000300042000004000000",
    "0000000300040020004000000"
  ]
}
