{
  "puzzle_info": {
    "grid_width": 4,
    "grid_height": 4,
    "steps_to_solve": 12
  },
  "solution_path": [
    "0000004030004030",
    "0040000030004030",
    "0040000000034030",
    "0040000000004033",
    "0040003000004003",
    "4000003000004003",
    "0000003040004003",
    "0000003040000043",
    "0000003040400003",
    "0000003004400003",
    "0000003004040003",
    "0000003004043000",
    "3000003004040000"
  ]
}
