{
  "puzzle_info": {
    "grid_width": 4,
    "grid_height": 4,
    "steps_to_solve": 12
  },
  "solution_path": [
    "0000000000040102",
    "0004000000000102",
    "4000000000000102",
    "4002000000000100",
    "0042000000000100",
    "0040000000000102",
    "0040000000000120",
    "0040002000000100",
    "0004002000000100",
    "0000002000000104",
    "0000002000000140",
    "0000002000400100",
    "0000002000040100"
  ]
}
