{
  "puzzle_info": {
    "grid_width": 4,
    "grid_height": 4,
    "steps_to_solve": 12
  },
  "solution_path": [
    "0002000000032000",
    "0002000030002000",
    "3002000000002000",
    "0032000000002000",
    "0002000000002030",
    "0002000000000230",
    "0202000000000030",
    "0220000000000030",
    "0200000000200030",
    "0200000000200003",
    "0203000000200000",
    "0230000000200000",
    "0030000000200200"
  ]
}
