{
  "puzzle_info": {
    "grid_width": 4,
    "grid_height": 4,
    "steps_to_solve": 13
  },
  "solution_path": [
    "0040400002000200",
    "4040000002000200",
    "0440000002000200",
    "0440000000020200",
    "0440000000000202",
    "0440000000000022",
    "0400000000400022",
    "0402000000400020",
    "0420000000400020",
    "0400002000400020",
    "0400002040000020",
    "0400002040200000",
    "0400002004200000",
    "0400002004000020"
  ]
}
