{
  "puzzle_info": {
    "grid_width": 4,
    "grid_height": 4,
    "steps_to_solve": 13
  },
  "solution_path": [
    "0004003000042000",
    "0000003400042000",
    "2000003400040000",
    "2000003440000000",
    "2000403400000000",
    "2000043400000000",
    "0000043400002000",
    "0000040400002030",
    "0000044000002030",
    "0000044000000230",
    "0000044002000030",
    "0400004002000030",
    "0400004002300000",
    "0400004002030000"
  ]
}
