{
  "puzzle_info": {
    "grid_width": 4,
    "grid_height": 4,
    "steps_to_solve": 13
  },
  "solution_path": [
    "0002300002040000",
    "0000300202040000",
    "0000000202043000",
    "0000200002043000",
    "0000200000243000",
    "0004200000203000",
    "0004200030200000",
    "2004000030200000",
    "0024000030200000",
    "0004002030200000",
    "4000002030200000",
    "0000402030200000",
    "0000402003200000",
    "0000402003020000"
  ]
}
