{
  "puzzle_info": {
    "grid_width": 4,
    "grid_height": 4,
    "steps_to_solve": 13
  },
  "solution_path": [
    "4004300000000040",
    "0044300000000040",
    "0044000000003040",
    "0044004000003000",
    "4004004000003000",
    "4400004000003000",
    "0400004040003000",
    "0400004040000003",
    "0000004040000403",
    "0000004040000430",
    "0400004040000030",
    "0400004040300000",
    "0400004004300000",
    "0400004004030000"
  ]
}
