{
  "puzzle_info": {
    "grid_width": 4,
    "grid_height": 4,
    "steps_to_solve": 13
  },
  "solution_path": [
    "0000000000004302",
    "4000000000000302",
    "4002000000000300",
    "4200000000000300",
    "4000000002000300",
    "0004000002000300",
    "0004000002000003",
    "0000000002040003",
    "0000000002400003",
    "0200000000400003",
    "0203000000400000",
    "0230000000400000",
    "0200003000400000",
    "0200003040000000"
  ]
}
