{
  "puzzle_info": {
    "grid_width": 4,
    "grid_height": 4,
    "steps_to_solve": 13
  },
  "solution_path": [
    "0340000000000001",
    "0300000000000041",
    "0003000000000041",
    "0000000000030041",
    "0000000030000041",
    "0040000030000001",
    "0004000030000001",
    "0000000030040001",
    "0000000034000001",
    "3000000004000001",
    "0003000004000001",
    "0000000004030001",
    "0000000004300001",
    "0000000040300001"
  ]
}
