{
  "puzzle_info": {
    "grid_width": 4,
    "grid_height": 4,
    "steps_to_solve": 13
  },
  "solution_path": [
    "0304400000200000",
    "0340400000200000",
    "0040400000200300",
    "0000404000200300",
    "0000404000203000",
    "0000004040203000",
    "0000004042003000",
    "0000004042000003",
    "0000004040000203",
    "0000004040000230",
    "0200004040000030",
    "0200004040300000",
    "0200004004300000",
    "0200004004030000"
  ]
}
