{
  "puzzle_info": {
    "grid_width": 4,
    "grid_height": 4,
    "steps_to_solve": 13
  },
  "solution_path": [
    "0200000003004000",
    "0200000000004300",
    "0000000002004300",
    "4000000002000300",
    "0004000002000300",
    "0004000002003000",
    "3004000002000000",
    "3400000002000000",
    "3000040002000000",
    "0003040002000000",
    "0003040000020000",
    "0000040300020000",
    "0000043000020000",
    "0000003000020400"
  ]
}
