{
  "puzzle_info": {
    "grid_width": 4,
    "grid_height": 4,
    "steps_to_solve": 13
  },
  "solution_path": [
    "0303010000430000",
    "3003010000430000",
    "0003010000433000",
    "3000010000433000",
    "0000010030433000",
    "0040010030033000",
    "4000010030033000",
    "0000410030033000",
    "0000410000333000",
    "0000410000303003",
    "0000410000303300",
    "0000410030300300",
    "0000410003300300",
    "0000410003030300"
  ]
}
