{
  "puzzle_info": {
    "grid_width": 4,
    "grid_height": 4,
    "steps_to_solve": 10
  },
  "solution_path": [
    "0120000000200040",
    "0100002000200040",
    "0100200000200040",
    "0100200000204000",
    "0100200040200000",
    "0100000240200000",
    "0102000040200000",
    "0120000040200000",
    "0100002040200000",
    "0100002004200000",
    "0100002004020000"
  ]
}
