{
  "puzzle_info": {
    "grid_width": 4,
    "grid_height": 4,
    "steps_to_solve": 13
  },
  "solution_path": [
    "1400000000020000",
    "1000000000020400",
    "1002000000000400",
    "1200000000000400",
    "1200000000000004",
    "1000000000000204",
    "1004000000000200",
    "1400000000000200",
    "1000000004000200",
    "1000000004000002",
    "1002000004000000",
    "1200000004000000",
    "1000020004000000",
    "1000020000040000"
  ]
}
