{
  "puzzle_info": {
    "grid_width": 4,
    "grid_height": 4,
    "steps_to_solve": 12
  },
  "solution_path": [
    "0004200400000110",
    "4000200400000110",
    "4000002400000110",
    "4000000400200110",
    "4004000000200110",
    "0044000000200110",
    "0004004000200110",
    "4000004000200110",
    "4000004020000110",
    "4000204000000110",
    "0004204000000110",
    "0000204000000114",
    "0000024000000114"
  ]
}
