{
  "puzzle_info": {
    "grid_width": 4,
    "grid_height": 4,
    "steps_to_solve": 11
  },
  "solution_path": [
    "3011004000000000",
    "0311004000000000",
    "0011004000000300",
    "0011400000000300",
    "4011000000000300",
    "0411000000000300",
    "0011000004000300",
    "0011000004003000",
    "3011000004000000",
    "0311000004000000",
    "0011030004000000",
    "0011030000040000"
  ]
}
