{
  "puzzle_info": {
    "grid_width": 5,
    "grid_height": 5,
    "steps_to_solve": 8
  },
  "solution_path": [
    "3000000003000000000000000",
    "3000300000000000000000000",
    "0003300000000000000000000",
    "0000300000000000000000030",
    "3000000000000000000000030",
    "0000000000000000000030030",
    "0000000000000000000000330",
    "0030000000000000000000030",
    "0030000000000000000000003"
  ]
}
