{
  "puzzle_info": {
    "grid_width": 4,
    "grid_height": 4,
    "steps_to_solve": 13
  },
  "solution_path": [
    "0200000030000040",
    "0200000000030040",
    "0203000000000040",
    "0230000000000040",
    "0230000000004000",
    "0030000000004200",
    "4030000000000200",
    "0430000000000200",
    "0030000004000200",
    "0030000004002000",
    "2030000004000000",
    "0230000004000000",
    "0030020004000000",
    "0030020040000000"
  ]
}
