{
  "puzzle_info": {
    "grid_width": 4,
    "grid_height": 4,
    "steps_to_solve": 12
  },
  "solution_path": [
    "0002030100010320",
    "2000030100010320",
    "2000000103010320",
    "2000000130010320",
    "2020000130010300",
    "2200000130010300",
    "0200200130010300",
    "0200200100310300",
    "0000200102310300",
    "0000200102313000",
    "0000200132310000",
    "2000000132310000",
    "0002000132310000"
  ]
}
