{
  "puzzle_info": {
    "grid_width": 4,
    "grid_height": 4,
    "steps_to_solve": 12
  },
  "solution_path": [
    "0000004440000300",
    "0000000440000340",
    "0004000040000340",
    "4004000000000340",
    "4400000000000340",
    "0400000000004340",
    "0400030000004040",
    "0400030000000440",
    "0400030004000040",
    "0400000304000040",
    "0000040304000040",
    "0000043004000040",
    "0400003004000040"
  ]
}
