{
  "puzzle_info": {
    "grid_width": 5,
    "grid_height": 5,
    "steps_to_solve": 16
  },
  "solution_path": [
    "2000000000000403000000000",
    "0000000000200403000000000",
    "0004000000200003000000000",
    "4000000000200003000000000",
    "0000040000200003000000000",
    "0000040000000023000000000",
    "0000040000300020000000000",
    "0000000004300020000000000",
    "0000000004320000000000000",
    "0000000004020000000030000",
    "0000000004020000000000003",
    "0000000004020030000000000",
    "0000000004023000000000000",
    "0000000000023000000000004",
    "0000000000003000000002004",
    "0000000000003000000002400",
    "0000000000003000000020400"
  ]
}
