{
  "puzzle_info": {
    "grid_width": 4,
    "grid_height": 4,
    "steps_to_solve": 13
  },
  "solution_path": [
    "0013002200000200",
    "0013002000000202",
    "0010002000030202",
    "0010002030000202",
    "0010002000003202",
    "0010002000003220",
    "0010000000203220",
    "0210000000203020",
    "0210000000203200",
    "0010000002203200",
    "3010000002200200",
    "0310000002200200",
    "0010030002200200",
    "0010030020200200"
  ]
}
