{
  "puzzle_info": {
    "grid_width": 5,
    "grid_height": 5,
    "steps_to_solve": 15
  },
  "solution_path": [
    "0002020000000000000030000",
    "0000020000000000000030020",
    "0000020000300000000000020",
    "0000020000000030000000020",
    "0000020000000030000020000",
    "0000020000200030000000000",
    "0000000002200030000000000",
    "0000000002230000000000000",
    "0000000002030000000020000",
    "0000000002030000000000002",
    "0000000002030020000000000",
    "0000200000030020000000000",
    "0000200000032000000000000",
    "0300200000002000000000000",
    "0320000000002000000000000",
    "3020000000002000000000000"
  ]
}
