{
  "puzzle_info": {
    "grid_width": 4,
    "grid_height": 4,
    "steps_to_solve": 12
  },
  "solution_path": [
    "0000000000002203",
    "0003000000002200",
    "3000000000002200",
    "3000200000000200",
    "3000200000002000",
    "3000200020000000",
    "3000000220000000",
    "0000300220000000",
    "0000003220000000",
    "0002003020000000",
    "2000003020000000",
    "0000203020000000",
    "0000203000020000"
  ]
}
