{
  "puzzle_info": {
    "grid_width": 4,
    "grid_height": 4,
    "steps_to_solve": 12
  },
  "solution_path": [
    "3040000000400001",
    "0040000000403001",
    "0000004000403001",
    "0000400000403001",
    "0000400030400001",
    "0000000430400001",
    "0000000030440001",
    "0000000034040001",
    "0000000034400001",
    "0400000030400001",
    "0400000003400001",
    "0000040003400001",
    "0000040000400301"
  ]
}
