{
  "puzzle_info": {
    "grid_width": 4,
    "grid_height": 4,
    "steps_to_solve": 12
  },
  "solution_path": [
    "0004000304000040",
    "4000000304000040",
    "4000000004000043",
    "4000000000040043",
    "4000000000044003",
    "4000000000044300",
    "4000400000040300",
    "0004400000040300",
    "0000400400040300",
    "0000440000040300",
    "0000440003040000",
    "0000440003400000",
    "0000440000400300"
  ]
}
