{
  "puzzle_info": {
    "grid_width": 4,
    "grid_height": 4,
    "steps_to_solve": 13
  },
  "solution_path": [
    "0000000030040042",
    "0004000030000042",
    "4000000030000042",
    "0000400030000042",
    "0000000430000042",
    "0040000430000002",
    "0040000430020000",
    "0040000432000000",
    "3040000402000000",
    "0340000402000000",
    "0040030402000000",
    "0000030402000040",
    "0000034002000040",
    "0300004002000040"
  ]
}
