{
  "puzzle_info": {
    "grid_width": 4,
    "grid_height": 4,
    "steps_to_solve": 13
  },
  "solution_path": [
    "0403230000000000",
    "0400230000000003",
    "0400030000002003",
    "0400030000002300",
    "0400000003002300",
    "0400000003002003",
    "0403000003002000",
    "0403000003000002",
    "0403000203000000",
    "0430000203000000",
    "0030040203000000",
    "0000040203000030",
    "0000042003000030",
    "0000402003000030"
  ]
}
