{
  "puzzle_info": {
    "grid_width": 5,
    "grid_height": 5,
    "steps_to_solve": 10
  },
  "solution_path": [
    "0000000002000000000000003",
    "0000020000000000000000003",
    "0000000000000000000020003",
    "0000300000000000000020000",
    "3000000000000000000020000",
    "0000000000000003000020000",
    "0000000000000000000320000",
    "2000000000000000000300000",
    "0000200000000000000300000",
    "0000000000000020000300000",
    "0000000000000023000000000"
  ]
}
