{
  "puzzle_info": {
    "grid_width": 5,
    "grid_height": 5,
    "steps_to_solve": 19
  },
  "solution_path": [
    "3000010240000000000000100",
    "0000310240000000000000100",
    "0000310204000000000000100",
    "0000310024000000000000100",
    "0000310020000000000000104",
    "0000010020000000000300104",
    "0000010020000003000000104",
    "0000010020000000000030104",
    "0000010020000000000003104",
    "0000010020000000000003140",
    "0000010020000400000003100",
    "0000012000000400000003100",
    "0000012000030400000000100",
    "0000010002030400000000100",
    "0000010000030400000000102",
    "0000010000030400000000120",
    "0000010000030400002000100",
    "0000010000034000002000100",
    "0000010000004000002003100",
    "0000010000004000002030100"
  ]
}
