{
  "puzzle_info": {
    "grid_width": 4,
    "grid_height": 4,
    "steps_to_solve": 13
  },
  "solution_path": [
    "0200000402003000",
    "0000020402003000",
    "0000002402003000",
    "0000002002003004",
    "3000002002000004",
    "3000002020000004",
    "0000302020000004",
    "0000302000002004",
    "0000302000000024",
    "0000302000200004",
    "0000302000204000",
    "0000302040200000",
    "0000032040200000",
    "0000030240200000"
  ]
}
