{
  "puzzle_info": {
    "grid_width": 4,
    "grid_height": 4,
    "steps_to_solve": 10
  },
  "solution_path": [
    "0102000000000200",
    "0100000000000202",
    "0100000000000022",
    "0102000000000020",
    "0120000000000020",
    "0100000000200020",
    "0100000000200002",
    "0102000000200000",
    "0120000000200000",
    "0100002000200000",
    "0100002000020000"
  ]
}
