{
  "puzzle_info": {
    "grid_width": 4,
    "grid_height": 4,
    "steps_to_solve": 11
  },
  "solution_path": [
    "0030302003000000",
    "3000302003000000",
    "3000320003000000",
    "3000320000000300",
    "3000300002000300",
    "3000000302000300",
    "3000000302003000",
    "3000300302000000",
    "3000003302000000",
    "3003003002000000",
    "3300003002000000",
    "0300003002003000"
  ]
}
