{
  "puzzle_info": {
    "grid_width": 5,
    "grid_height": 5,
    "steps_to_solve": 17
  },
  "solution_path": [
    "0300000400000000100000022",
    "0340000000000000100000022",
    "0340200000000000100000020",
    "0304200000000000100000020",
    "0300200000000000104000020",
    "0320000000000000104000020",
    "3020000000000000104000020",
    "0020000000000000104030020",
    "0000000000000000104030220",
    "0000000000000000104003220",
    "0020000000000000104003020",
    "0020000000000000104003200",
    "0020000200000000104003000",
    "0000200200000000104003000",
    "0000000200000000104003002",
    "0000000200000000104003200",
    "0000000200002000104003000",
    "0000000200000020104003000"
  ]
}
