{
  "puzzle_info": {
    "grid_width": 4,
    "grid_height": 4,
    "steps_to_solve": 11
  },
  "solution_path": [
    "0200002004000002",
    "0000022004000002",
    "0000020204000002",
    "0000020004020002",
    "0000020000420002",
    "0000020000422000",
    "0000020000022040",
    "0000020000020240",
    "0000020002020040",
    "0040020002020000",
    "0040020002200000",
    "0040020020200000"
  ]
}
