{
  "puzzle_info": {
    "grid_width": 5,
    "grid_height": 5,
    "steps_to_solve": 12
  },
  "solution_path": [
    "0020010010000000000030000",
    "0020010010000000000000003",
    "0000010010000000000000203",
    "0000010010000000000000023",
    "0000010010000200000000003",
    "0000010010000200000030000",
    "0000010010300200000000000",
    "0000010010003200000000000",
    "0000010010003000000000020",
    "0000010010003000000020000",
    "0000010010203000000000000",
    "0000010010023000000000000",
    "0030010010020000000000000"
  ]
}
