{
  "puzzle_info": {
    "grid_width": 4,
    "grid_height": 4,
    "steps_to_solve": 11
  },
  "solution_path": [
    "0000002002001040",
    "0200002000001040",
    "2000002000001040",
    "2000002000401000",
    "2000002040001000",
    "0000202040001000",
    "0000022040001000",
    "0000022000041000",
    "0000022000001004",
    "0000022000001400",
    "0000022004001000",
    "0000202004001000"
  ]
}
