{
  "puzzle_info": {
    "grid_width": 4,
    "grid_height": 4,
    "steps_to_solve": 12
  },
  "solution_path": [
    "0030000000001300",
    "3000000000001300",
    "0000000030001300",
    "0000000000031300",
    "0300000000031000",
    "3000000000031000",
    "0000000030031000",
    "0000000000331000",
    "0003000000301000",
    "3000000000301000",
    "0000000030301000",
    "0000000003301000",
    "0000000003001030"
  ]
}
