{
  "puzzle_info": {
    "grid_width": 4,
    "grid_height": 4,
    "steps_to_solve": 13
  },
  "solution_path": [
    "1000000000000043",
    "1040000000000003",
    "1004000000000003",
    "1004000300000000",
    "1400000300000000",
    "1000000300000400",
    "1000000300004000",
    "1000400300000000",
    "1000004300000000",
    "1000004000000003",
    "1000004000003000",
    "1000304000000000",
    "1000034000000000",
    "1000030400000000"
  ]
}
