{
  "puzzle_info": {
    "grid_width": 4,
    "grid_height": 4,
    "steps_to_solve": 12
  },
  "solution_path": [
    "0303000200200000",
    "0033000200200000",
    "0033000220000000",
    "0003000220000030",
    "3000000220000030",
    "0000300220000030",
    "0000003220000030",
    "0002003020000030",
    "2000003020000030",
    "0000203020000030",
    "0000203020300000",
    "0000203002300000",
    "0000203002000030"
  ]
}
