{
  "puzzle_info": {
    "grid_width": 4,
    "grid_height": 4,
    "steps_to_solve": 12
  },
  "solution_path": [
    "2000000033000000",
    "2000300003000000",
    "0002300003000000",
    "0002300000030000",
    "0000300200030000",
    "0000003200030000",
    "0000003200000003",
    "0000003000020003",
    "0000003020000003",
    "0003003020000000",
    "3000003020000000",
    "0000303020000000",
    "0000033020000000"
  ]
}
