{
  "puzzle_info": {
    "grid_width": 5,
    "grid_height": 5,
    "steps_to_solve": 18
  },
  "solution_path": [
    "0000200004000000000001030",
    "2000000004000000000001030",
    "2000400000000000000001030",
    "0002400000000000000001030",
    "0000400000000000002001030",
    "0000400000000000002001300",
    "0030400000000000002001000",
    "0003400000000000002001000",
    "0000400000000300002001000",
    "0000000000000300002001004",
    "0000000000000300002001400",
    "0000000000000300000001420",
    "0040000000000300000001020",
    "0040000000000300000001200",
    "0000000000000300040001200",
    "0000000000000300040001002",
    "0000200000000300040001000",
    "2000000000000300040001000",
    "0000000000000300040021000"
  ]
}
