{
  "puzzle_info": {
    "grid_width": 5,
    "grid_height": 5,
    "steps_to_solve": 17
  },
  "solution_path": [
    "4000000004100310000000040",
    "0000040004100310000000040",
    "0000044000100310000000040",
    "0000044000100310004000000",
    "0003044000100010004000000",
    "0000344000100010004000000",
    "0000044003100010004000000",
    "0000044300100010004000000",
    "0000040300100010004004000",
    "0000004300100010004004000",
    "0000000300100010404004000",
    "0000000300100010044004000",
    "0000000300100010044040000",
    "0000000300100014044000000",
    "0000000300100010444000000",
    "0000000300104010404000000",
    "0030000000104010404000000",
    "3000000000104010404000000"
  ]
}
