{
  "puzzle_info": {
    "grid_width": 4,
    "grid_height": 4,
    "steps_to_solve": 13
  },
  "solution_path": [
    "0242000000040000",
    "2042000000040000",
    "2402000000040000",
    "0402000000042000",
    "0400000200042000",
    "0400200000042000",
    "0400200020040000",
    "0400000220040000",
    "0400000224000000",
    "0000040224000000",
    "0000042024000000",
    "0000042020000400",
    "0000042000020400",
    "0000042004020000"
  ]
}
