{
  "puzzle_info": {
    "grid_width": 5,
    "grid_height": 5,
    "steps_to_solve": 18
  },
  "solution_path": [
    "0000004000000000000033020",
    "0000000000000000400033020",
    "3000000000000000400003020",
    "3000000000000000400000320",
    "3002000000000000400000300",
    "0032000000000000400000300",
    "0002000000000000430000300",
    "0002000000000000400300300",
    "0002000000000000004300300",
    "0000000000000200004300300",
    "0000000000000204000300300",
    "0000000000000204300000300",
    "4000000000000200300000300",
    "4030000000000200300000000",
    "0430000000000200300000000",
    "0030000000040200300000000",
    "0030000000004200300000000",
    "0000000300004200300000000",
    "0000000300000200300000400"
  ]
}
