{
  "puzzle_info": {
    "grid_width": 4,
    "grid_height": 4,
    "steps_to_solve": 12
  },
  "solution_path": [
    "0400030000000203",
    "4000030000000203",
    "0000030000004203",
    "0003030000004200",
    "0003030000004002",
    "0003030200004000",
    "3000030200004000",
    "0000030230004000",
    "0000030230000004",
    "0000030230040000",
    "0000032030040000",
    "0300002030040000",
    "0300002034000000"
  ]
}
