{
  "puzzle_info": {
    "grid_width": 5,
    "grid_height": 5,
    "steps_to_solve": 9
  },
  "solution_path": [
    "0030000000000000000040000",
    "0000000000000000000040300",
    "4000000000000000000000300",
    "4000000000000000000030000",
    "4000030000000000000000000",
    "0000430000000000000000000",
    "0000030000000000000000004",
    "0000030000000000000040000",
    "0000030000400000000000000",
    "3000000000400000000000000"
  ]
}
