{
  "puzzle_info": {
    "grid_width": 4,
    "grid_height": 4,
    "steps_to_solve": 12
  },
  "solution_path": [
    "1000400000040000",
    "1000000400040000",
    "1004000000040000",
    "1400000000040000",
    "1000000000040400",
    "1004000000000400",
    "1400000000000400",
    "1000000004000400",
    "1000000004000004",
    "1004000004000000",
    "1400000004000000",
    "1000040004000000",
    "1000040000040000"
  ]
}
