{
  "puzzle_info": {
    "grid_width": 4,
    "grid_height": 4,
    "steps_to_solve": 13
  },
  "solution_path": [
    "0000400040110002",
    "4000000040110002",
    "4000000000114002",
    "4000000000114200",
    "4200000000114000",
    "4200000000110004",
    "4000000000110204",
    "4000000000110240",
    "4200000000110040",
    "4002000000110040",
    "0042000000110040",
    "0040000200110040",
    "0040200000110040",
    "0000204000110040"
  ]
}
