{
  "puzzle_info": {
    "grid_width": 4,
    "grid_height": 4,
    "steps_to_solve": 13
  },
  "solution_path": [
    "0403003000000200",
    "4003003000000200",
    "4300003000000200",
    "0300003000004200",
    "0300003000004002",
    "0300003000000042",
    "0300000000300042",
    "0302000000300040",
    "0320000000300040",
    "0300002000300040",
    "0300002030000040",
    "0300002030400000",
    "0300002003400000",
    "0300002003000040"
  ]
}
