{
  "puzzle_info": {
    "grid_width": 4,
    "grid_height": 4,
    "steps_to_solve": 12
  },
  "solution_path": [
    "0002302000010020",
    "2000302000010020",
    "2000320000010020",
    "2000300000010220",
    "2020300000010200",
    "0220300000010200",
    "0202300000010200",
    "0200300200010200",
    "0200320000010200",
    "0200300002010200",
    "0200000302010200",
    "0200020300010200",
    "0200020302010000"
  ]
}
