{
  "puzzle_info": {
    "grid_width": 4,
    "grid_height": 4,
    "steps_to_solve": 14
  },
  "solution_path": [
    "0020002002101030",
    "0002002002101030",
    "0000002002101032",
    "0000000202101032",
    "0000000002121032",
    "0000000020121032",
    "0000000020121302",
    "0000000020121320",
    "0300000020121020",
    "0300000002121020",
    "0300020000121020",
    "0003020000121020",
    "0000020300121020",
    "0000023000121020",
    "0030020000121020"
  ]
}
