{
  "puzzle_info": {
    "grid_width": 4,
    "grid_height": 4,
    "steps_to_solve": 13
  },
  "solution_path": [
    "0000300002000004",
    "3000000002000004",
    "3004000002000000",
    "3400000002000000",
    "3000040002000000",
    "0003040002000000",
    "0003040000020000",
    "0003040200000000",
    "0003042000000000",
    "0000042000000003",
    "0000002000000403",
    "0000002000000430",
    "0000002000300400",
    "0000200000300400"
  ]
}
