{
  "puzzle_info": {
    "grid_width": 4,
    "grid_height": 4,
    "steps_to_solve": 11
  },
  "solution_path": [
    "1000404000200000",
    "1000044000200000",
    "1000004000200400",
    "1040000000200400",
    "1400000000200400",
    "1000000004200400",
    "1020000004000400",
    "1200000004000400",
    "1000020004000400",
    "1000020000040400",
    "1000020004040000",
    "1000020000440000"
  ]
}
