{
  "puzzle_info": {
    "grid_width": 3,
    "grid_height": 3,
    "steps_to_solve": 9
  },
  "solution_path": [
    "102004231",
    "120004231",
    "120400231",
    "120430201",
    "120403201",
    "120043201",
    "120003241",
    "100023241",
    "100223041",
    "100223401"
  ]
}
