{
  "puzzle_info": {
    "grid_width": 4,
    "grid_height": 4,
    "steps_to_solve": 12
  },
  "solution_path": [
    "0000000030430004",
    "0000000000433004",
    "0003000000403004",
    "3000000000403004",
    "3000000000400034",
    "3004000000400030",
    "0034000000400030",
    "0004003000400030",
    "4000003000400030",
    "4000003040000030",
    "0000403040000030",
    "0000043040000030",
    "0000043000004030"
  ]
}
