{
  "puzzle_info": {
    "grid_width": 4,
    "grid_height": 4,
    "steps_to_solve": 13
  },
  "solution_path": [
    "2004000020000000",
    "0004200020000000",
    "4000200020000000",
    "4000000220000000",
    "0000400220000000",
    "0000420020000000",
    "0000420000002000",
    "0000020040002000",
    "0000020000042000",
    "2000020000040000",
    "0002020000040000",
    "0000020200040000",
    "0000022000040000",
    "0020020000040000"
  ]
}
