{
  "puzzle_info": {
    "grid_width": 4,
    "grid_height": 4,
    "steps_to_solve": 12
  },
  "solution_path": [
    "4000000303000003",
    "0000000303004003",
    "0300000300004003",
    "0300000300034000",
    "0300000330004000",
    "0300000330000004",
    "0300000330040000",
    "0300000334000000",
    "0000030334000000",
    "0000033034000000",
    "0300003034000000",
    "0300003004003000",
    "0300003004000003"
  ]
}
