{
  "puzzle_info": {
    "grid_width": 4,
    "grid_height": 4,
    "steps_to_solve": 12
  },
  "solution_path": [
    "4030040300000000",
    "0030040300004000",
    "3000040300004000",
    "0000040330004000",
    "0000004330004000",
    "0000004030004003",
    "0000004030000043",
    "0000004030400003",
    "0003004030400000",
    "3000004030400000",
    "0000304030400000",
    "0000034030400000",
    "0040030030400000"
  ]
}
