{
  "puzzle_info": {
    "grid_width": 4,
    "grid_height": 4,
    "steps_to_solve": 13
  },
  "solution_path": [
    "3000004040002000",
    "0000304040002000",
    "0000300440002000",
    "0000003440002000",
    "0000003040002004",
    "0000003040000024",
    "0000003040200004",
    "0030000040200004",
    "0030000004200004",
    "0030000004204000",
    "4030000004200000",
    "0430000004200000",
    "0030040004200000",
    "0030040000200400"
  ]
}
