{
  "puzzle_info": {
    "grid_width": 5,
    "grid_height": 5,
    "steps_to_solve": 18
  },
  "solution_path": [
    "0000000000000002000100004",
    "2000000000000000000100004",
    "2000000000000000000140000",
    "2000040000000000000100000",
    "0000240000000000000100000",
    "0000200004000000000100000",
    "0000200000000040000100000",
    "0000200000400000000100000",
    "0000000000400020000100000",
    "0000000000420000000100000",
    "4000000000020000000100000",
    "0000400000020000000100000",
    "0000000000020040000100000",
    "0000000000024000000100000",
    "0200000000004000000100000",
    "0000200000004000000100000",
    "0000000000004020000100000",
    "0000000000004200000100000",
    "0002000000004000000100000"
  ]
}
