{
  "puzzle_info": {
    "grid_width": 5,
    "grid_height": 5,
    "steps_to_solve": 20
  },
  "solution_path": [
    "4300000000000010000300000",
    "4000000000000010000303000",
    "4000000000000010000330000",
    "0000000000000014000330000",
    "0000000000000014300030000",
    "0000000000000014300000003",
    "0000000000000014300300000",
    "0000000000000014330000000",
    "0000000000000014030003000",
    "0000000000000010430003000",
    "0400000000000010030003000",
    "0400003000000010030000000",
    "0000403000000010030000000",
    "0000003004000010030000000",
    "0000003400000010030000000",
    "0300000400000010030000000",
    "0000300400000010030000000",
    "0000000403000010030000000",
    "0000000430000010030000000",
    "0000000030004010030000000",
    "0000000030004010000000300"
  ]
}
