{
  "puzzle_info": {
    "grid_width": 5,
    "grid_height": 5,
    "steps_to_solve": 21
  },
  "solution_path": [
    "2030000000000002100001003",
    "2000000000000002100001303",
    "0000200000000002100001303",
    "2000200000000000100001303",
    "0002200000000000100001303",
    "0002200000000000100001033",
    "0000200000000000102001033",
    "0000200003000000102001030",
    "0000200003000000102001003",
    "0000200003000030102001000",
    "0000230000000030102001000",
    "0000030002000030102001000",
    "0000000032000030102001000",
    "0000200030000030102001000",
    "2000000030000030102001000",
    "0000000030000030102021000",
    "0000000030300000102021000",
    "0000000030300002102001000",
    "0000000030000032102001000",
    "0000000030000002102001003",
    "0000000030000002102001300",
    "0030000030000002102001000"
  ]
}
