{
  "puzzle_info": {
    "grid_width": 4,
    "grid_height": 4,
    "steps_to_solve": 10
  },
  "solution_path": [
    "4200000001000000",
    "0200000001004000",
    "0200000001000004",
    "0204000001000000",
    "0024000001000000",
    "0004000001000020",
    "4000000001000020",
    "4020000001000000",
    "0420000001000000",
    "0020040001000000",
    "0000040001000020"
  ]
}
