{
  "puzzle_info": {
    "grid_width": 5,
    "grid_height": 5,
    "steps_to_solve": 15
  },
  "solution_path": [
    "0000303000000000000004000",
    "0000003000000000000004003",
    "0000003000040000000000003",
    "0000030000040000000000003",
    "0000030000000040000000003",
    "0000030000000040000030000",
    "0000030000300040000000000",
    "0000030000000340000000000",
    "0000030000000300000000004",
    "0000030000000300000040000",
    "0000030000400300000000000",
    "3000000000400300000000000",
    "3000000000004300000000000",
    "3040000000000300000000000",
    "0340000000000300000000000",
    "0300000000000300000000400"
  ]
}
