{
  "puzzle_info": {
    "grid_width": 4,
    "grid_height": 4,
    "steps_to_solve": 13
  },
  "solution_path": [
    "1000204014000300",
    "1000024014000300",
    "1040020014000300",
    "1400020014000300",
    "1400020014000003",
    "1403020014000000",
    "1403020010040000",
    "1403000010040200",
    "1003000014040200",
    "1300000014040200",
    "1000030014040200",
    "1000030010440200",
    "1000030012440000",
    "1300000012440000"
  ]
}
