{
  "puzzle_info": {
    "grid_width": 4,
    "grid_height": 4,
    "steps_to_solve": 10
  },
  "solution_path": [
    "0030000104000000",
    "0000000104000030",
    "0000000140000030",
    "0000000140000003",
    "0000000140030000",
    "0000000143000000",
    "0000000103004000",
    "0000000103000004",
    "0000000103040000",
    "0000000103400000",
    "0040000103000000"
  ]
}
