{
  "puzzle_info": {
    "grid_width": 5,
    "grid_height": 5,
    "steps_to_solve": 17
  },
  "solution_path": [
    "1000040000000004000000000",
    "1000000004000004000000000",
    "1000400000000004000000000",
    "1400000000000004000000000",
    "1000000000000004000004000",
    "1000000000000000000404000",
    "1000400000000000000004000",
    "1400000000000000000004000",
    "1000000000000000400004000",
    "1000000000000000400000004",
    "1000400000000000400000000",
    "1400000000000000400000000",
    "1000000000040000400000000",
    "1000000000040000000400000",
    "1000400000040000000000000",
    "1400000000040000000000000",
    "1000004000040000000000000",
    "1000004000000000000004000"
  ]
}
