{
  "puzzle_info": {
    "grid_width": 4,
    "grid_height": 4,
    "steps_to_solve": 10
  },
  "solution_path": [
    "0000000001040002",
    "0000000001400002",
    "0002000001400000",
    "0002000001040000",
    "0002000401000000",
    "2000000401000000",
    "0000000401002000",
    "0000000401000002",
    "0000000401020000",
    "0000400001020000",
    "0000400001200000"
  ]
}
