{
  "puzzle_info": {
    "grid_width": 4,
    "grid_height": 4,
    "steps_to_solve": 12
  },
  "solution_path": [
    "4000202000400000",
    "4000202000000040",
    "4000200000200040",
    "4000200000204000",
    "4000000020204000",
    "4000000020200004",
    "4004000020200000",
    "0044000020200000",
    "0004004020200000",
    "4000004020200000",
    "0000404020200000",
    "0000044020200000",
    "0000040420200000"
  ]
}
