{
  "puzzle_info": {
    "grid_width": 4,
    "grid_height": 4,
    "steps_to_solve": 11
  },
  "solution_path": [
    "0041020000000000",
    "4001020000000000",
    "4201000000000000",
    "4021000000000000",
    "4001000000000020",
    "0041000000000020",
    "0001000000400020",
    "0001000000402000",
    "2001000000400000",
    "0021000000400000",
    "0001002000400000",
    "0001002040000000"
  ]
}
