{
  "puzzle_info": {
    "grid_width": 4,
    "grid_height": 4,
    "steps_to_solve": 10
  },
  "solution_path": [
    "0000010020000004",
    "2000010000000004",
    "0002010000000004",
    "0002010400000000",
    "2000010400000000",
    "0000010400002000",
    "0000014000002000",
    "0000010000002040",
    "0000010000000240",
    "0000010002000040",
    "0040010002000000"
  ]
}
