{
  "puzzle_info": {
    "grid_width": 5,
    "grid_height": 5,
    "steps_to_solve": 14
  },
  "solution_path": [
    "0004000400000040000000040",
    "0000000400000040004000040",
    "0000000400400000004000040",
    "0000000400400000004040000",
    "0000000400400004004000000",
    "0000000400400000044000000",
    "0004000400400000040000000",
    "4000000400400000040000000",
    "0000040400400000040000000",
    "0000004400400000040000000",
    "0000004000404000040000000",
    "0000004000400040040000000",
    "0000004000000440040000000",
    "0000404000000400040000000",
    "4000004000000400040000000"
  ]
}
