{
  "puzzle_info": {
    "grid_width": 4,
    "grid_height": 4,
    "steps_to_solve": 13
  },
  "solution_path": [
    "4000200400030000",
    "4000240000030000",
    "4000040000032000",
    "4000040000030002",
    "0000040000034002",
    "0000040000034200",
    "4000040000030200",
    "0004040000030200",
    "0004040300000200",
    "0004043000000200",
    "0000043000000204",
    "0000043000000240",
    "0000043002000040",
    "0400003002000040"
  ]
}
