{
  "puzzle_info": {
    "grid_width": 4,
    "grid_height": 4,
    "steps_to_solve": 10
  },
  "solution_path": [
    "0000000000102004",
    "2000000000100004",
    "2000000000104000",
    "0000000020104000",
    "0000000002104000",
    "0200000000104000",
    "0200000000100004",
    "0204000000100000",
    "0240000000100000",
    "0040000000100200",
    "0000004000100200"
  ]
}
