{
  "puzzle_info": {
    "grid_width": 4,
    "grid_height": 4,
    "steps_to_solve": 13
  },
  "solution_path": [
    "0400003000200000",
    "0000003000200400",
    "0000003000000420",
    "0000003000000402",
    "0000003000000042",
    "0000003000400002",
    "0000300000400002",
    "0000300000402000",
    "0000300020400000",
    "3000000020400000",
    "3000000002400000",
    "3040000002000000",
    "0340000002000000",
    "0300000002000040"
  ]
}
