{
  "puzzle_info": {
    "grid_width": 4,
    "grid_height": 4,
    "steps_to_solve": 11
  },
  "solution_path": [
    "0300000200000330",
    "0300000000000332",
    "0300030000000032",
    "0300030000003002",
    "0300030000003200",
    "0300030002003000",
    "0300000302003000",
    "0000030302003000",
    "0000030302000003",
    "0000030302030000",
    "0000033002030000",
    "0000303002030000"
  ]
}
