{
  "puzzle_info": {
    "grid_width": 4,
    "grid_height": 4,
    "steps_to_solve": 12
  },
  "solution_path": [
    "0400000000000240",
    "0400000000002040",
    "0400000000002400",
    "0400040000002000",
    "4000040000002000",
    "4000040000000002",
    "0000040000004002",
    "0000040000004200",
    "0000040002004000",
    "0000000402004000",
    "0000000402000004",
    "0000000402040000",
    "0000000402400000"
  ]
}
