{
  "puzzle_info": {
    "grid_width": 4,
    "grid_height": 4,
    "steps_to_solve": 10
  },
  "solution_path": [
    "3000000003000030",
    "3030000003000000",
    "0330000003000000",
    "0030030003000000",
    "0003030003000000",
    "0003030000030000",
    "0000030300030000",
    "0000033000030000",
    "0000303000030000",
    "0000303000000003",
    "0000303000003000"
  ]
}
