{
  "puzzle_info": {
    "grid_width": 5,
    "grid_height": 5,
    "steps_to_solve": 10
  },
  "solution_path": [
    "0000000000000000000300002",
    "0000000000000003000000002",
    "0000000000000000000030002",
    "0000200000000000000030000",
    "2000000000000000000030000",
    "0000000000000002000030000",
    "0000000000000000000230000",
    "3000000000000000000200000",
    "0000300000000000000200000",
    "0000000000000030000200000",
    "0000000000300000000200000"
  ]
}
