{
  "puzzle_info": {
    "grid_width": 4,
    "grid_height": 4,
    "steps_to_solve": 12
  },
  "solution_path": [
    "0304000000000040",
    "0340000000000040",
    "0040000000000340",
    "0000000000400340",
    "0000000000403040",
    "0000000000403400",
    "3000000000400400",
    "0003000000400400",
    "0403000000400000",
    "0430000000400000",
    "0030000000400400",
    "0000003000400400",
    "0000003000040400"
  ]
}
