{
  "puzzle_info": {
    "grid_width": 4,
    "grid_height": 4,
    "steps_to_solve": 10
  },
  "solution_path": [
    "0000000133000020",
    "0300000130000020",
    "0300000130000002",
    "0300000130020000",
    "0300000132000000",
    "0300000102003000",
    "0300000102000003",
    "0300000102030000",
    "0300000102300000",
    "0300020100300000",
    "0003020100300000"
  ]
}
