{
  "puzzle_info": {
    "grid_width": 4,
    "grid_height": 4,
    "steps_to_solve": 11
  },
  "solution_path": [
    "3040040004000000",
    "0040040004003000",
    "0000040004003040",
    "0400000004003040",
    "0400040000003040",
    "0400040000000340",
    "0400040003000040",
    "0400000403000040",
    "0000040403000040",
    "0000044003000040",
    "0000404003000040",
    "0000404003000004"
  ]
}
