{
  "puzzle_info": {
    "grid_width": 4,
    "grid_height": 4,
    "steps_to_solve": 13
  },
  "solution_path": [
    "0400000000020030",
    "0402000000000030",
    "0042000000000030",
    "0040000000000032",
    "0040000000003002",
    "0040000000003200",
    "3040000000000200",
    "0340000000000200",
    "0040000003000200",
    "0040000003002000",
    "2040000003000000",
    "0240000003000000",
    "0040020003000000",
    "0040020000030000"
  ]
}
