{
  "puzzle_info": {
    "grid_width": 5,
    "grid_height": 5,
    "steps_to_solve": 14
  },
  "solution_path": [
    "0400000001004000010000002",
    "0000000001004000010004002",
    "0000000001004020010004000",
    "0000000001000420010004000",
    "0004000001000020010004000",
    "0004000001200000010004000",
    "2004000001000000010004000",
    "0024000001000000010004000",
    "0004000001002000010004000",
    "0000000001002000010004040",
    "0000000001002000010000440",
    "0000000001002000010000404",
    "0000000001002040010000400",
    "0000000001002400010000400",
    "0020000001000400010000400"
  ]
}
