{
  "puzzle_info": {
    "grid_width": 4,
    "grid_height": 4,
    "steps_to_solve": 12
  },
  "solution_path": [
    "0330000210000400",
    "0330040210000000",
    "3030040210000000",
    "0030340210000000",
    "0030304210000000",
    "0030300210000040",
    "0030003210000040",
    "0030000210300040",
    "0030200010300040",
    "0030203010000040",
    "0030023010000040",
    "0030023010400000",
    "0030020310400000"
  ]
}
