{
  "puzzle_info": {
    "grid_width": 4,
    "grid_height": 4,
    "steps_to_solve": 12
  },
  "solution_path": [
    "0004000003000001",
    "0000000003040001",
    "0000000000340001",
    "0030000000040001",
    "0030000040000001",
    "0030000000004001",
    "0030000000000041",
    "0030004000000001",
    "3000004000000001",
    "0000004000003001",
    "0000004000000031",
    "0000004000300001",
    "0000000400300001"
  ]
}
