{
  "puzzle_info": {
    "grid_width": 4,
    "grid_height": 4,
    "steps_to_solve": 11
  },
  "solution_path": [
    "0004000400000040",
    "0004400000000040",
    "0004400000000004",
    "0000400000040004",
    "0000400000044000",
    "0000400040040000",
    "0000400000440000",
    "0000400000400004",
    "0000400000404000",
    "0000400040400000",
    "0000400004400000",
    "0040400004000000"
  ]
}
