{
  "puzzle_info": {
    "grid_width": 4,
    "grid_height": 4,
    "steps_to_solve": 13
  },
  "solution_path": [
    "0000000000040430",
    "0004000000000430",
    "0004000000004030",
    "0004000000004300",
    "4004000000000300",
    "0044000000000300",
    "0040000000000304",
    "0040000000000340",
    "0040004000000300",
    "0004004000000300",
    "0000004000000304",
    "0000004000000340",
    "0000004000400300",
    "0000400000400300"
  ]
}
