{
  "puzzle_info": {
    "grid_width": 4,
    "grid_height": 4,
    "steps_to_solve": 13
  },
  "solution_path": [
    "0000000000001430",
    "0030000000001400",
    "3000000000001400",
    "0000000030001400",
    "0000000000031400",
    "0400000000031000",
    "4000000000031000",
    "0000000040031000",
    "0000000000431000",
    "0003000000401000",
    "3000000000401000",
    "0000000030401000",
    "0000000003401000",
    "0000000003041000"
  ]
}
