{
  "puzzle_info": {
    "grid_width": 5,
    "grid_height": 5,
    "steps_to_solve": 14
  },
  "solution_path": [
    "0300400000000000040000000",
    "0340400000000000000000000",
    "0304400000000000000000000",
    "0034400000000000000000000",
    "0030400000000000000000040",
    "0034000000000000000000040",
    "0030000000000000004000040",
    "0030000000000000004000004",
    "0030400000000000004000000",
    "0034000000000000004000000",
    "0030000000000400004000000",
    "0030000000000404000000000",
    "4030000000000400000000000",
    "0430000000000400000000000",
    "0400000000000400000000300"
  ]
}
