{
  "puzzle_info": {
    "grid_width": 5,
    "grid_height": 5,
    "steps_to_solve": 21
  },
  "solution_path": [
    "1000000030000000000304000",
    "1000000003000000000304000",
    "1000000000000030000304000",
    "1000000000000033000004000",
    "1000000000000033000000004",
    "1000000000000033000400000",
    "1000000000000033400000000",
    "1000030000000030400000000",
    "1000000003000030400000000",
    "1000300000000030400000000",
    "1300000000000030400000000",
    "1000000000030030400000000",
    "1000000000000330400000000",
    "1000300000000300400000000",
    "1300000000000300400000000",
    "1000000000030300400000000",
    "1000000000030300000400000",
    "1000400000030300000000000",
    "1400000000030300000000000",
    "1000004000030300000000000",
    "1000004000003300000000000",
    "1000004000003030000000000"
  ]
}
