{
  "puzzle_info": {
    "grid_width": 4,
    "grid_height": 4,
    "steps_to_solve": 12
  },
  "solution_path": [
    "0304000000010000",
    "0004000000010300",
    "4000000000010300",
    "4000000000013000",
    "4000300000010000",
    "0004300000010000",
    "0000300400010000",
    "0000340000010000",
    "3000040000010000",
    "0003040000010000",
    "0000040300010000",
    "0000043000010000",
    "0000040000010030"
  ]
}
