{
  "puzzle_info": {
    "grid_width": 4,
    "grid_height": 4,
    "steps_to_solve": 10
  },
  "solution_path": [
    "0000013000020000",
    "0030010000020000",
    "0003010000020000",
    "0003010200000000",
    "3000010200000000",
    "0000010200003000",
    "0000012000003000",
    "0000010000003020",
    "0000010000000320",
    "0000010003000020",
    "0020010003000000"
  ]
}
