{
  "puzzle_info": {
    "grid_width": 4,
    "grid_height": 4,
    "steps_to_solve": 13
  },
  "solution_path": [
    "0430000000304000",
    "4030000000304000",
    "0030000040304000",
    "3000000040304000",
    "3000000043004000",
    "3000400003004000",
    "3000000403004000",
    "3000400403000000",
    "3000004403000000",
    "3040000403000000",
    "0340000403000000",
    "0040030403000000",
    "0000030403000040",
    "0000034003000040"
  ]
}
