{
  "puzzle_info": {
    "grid_width": 5,
    "grid_height": 5,
    "steps_to_solve": 17
  },
  "solution_path": [
    "4010000010000002000002000",
    "0010000010400002000002000",
    "0010000010000042000002000",
    "0010000010000040000022000",
    "0010000010000040000020002",
    "0010000010000040000000022",
    "0010000010000240000000002",
    "0010000010200040000000002",
    "0010000010240000000000002",
    "0010000010040000000020002",
    "0010000010040000000000022",
    "0010000010040200000000002",
    "0010000010040200000020000",
    "2010000010040200000000000",
    "0210000010040200000000000",
    "0010002010040200000000000",
    "0010002010004200000000000",
    "0010002010004000000000020"
  ]
}
