{
  "puzzle_info": {
    "grid_width": 5,
    "grid_height": 5,
    "steps_to_solve": 14
  },
  "solution_path": [
    "0000000400200000000000020",
    "0040000000200000000000020",
    "0000400000200000000000020",
    "0000400000000000000020020",
    "0000400000000000000000220",
    "0020400000000000000000020",
    "0024000000000000000000020",
    "0004000000000000000000220",
    "0004000020000000000000200",
    "0000400020000000000000200",
    "0000000020000000000000204",
    "0000000020000000000000240",
    "0020000020000000000000040",
    "0020000020000400000000000",
    "0020000020400000000000000"
  ]
}
