{
  "puzzle_info": {
    "grid_width": 4,
    "grid_height": 4,
    "steps_to_solve": 13
  },
  "solution_path": [
    "0000002040000300",
    "0000002000004300",
    "0000002000004003",
    "0000000000004023",
    "0000000000004203",
    "0000000000004230",
    "0200000000004030",
    "0200000000000430",
    "0200040000000030",
    "2000040000000030",
    "0000040000002030",
    "0000040000000230",
    "0000040002000030",
    "0000040000020030"
  ]
}
