{
  "puzzle_info": {
    "grid_width": 4,
    "grid_height": 4,
    "steps_to_solve": 13
  },
  "solution_path": [
    "3003000000004000",
    "0003000030004000",
    "3000000030004000",
    "3000000000034000",
    "0000000030034000",
    "0000000033004000",
    "3000000003004000",
    "3000400003000000",
    "0003400003000000",
    "0000400003000003",
    "0000000403000003",
    "0000000403030000",
    "0000000403300000",
    "0000000400300300"
  ]
}
