{
  "puzzle_info": {
    "grid_width": 4,
    "grid_height": 4,
    "steps_to_solve": 12
  },
  "solution_path": [
    "0103000030031020",
    "0100000330031020",
    "0100300030031020",
    "0100300033001020",
    "0100330030001020",
    "0100330000031020",
    "0120330000031000",
    "0102330000031000",
    "0100330200031000",
    "0100330200001003",
    "0100330200001300",
    "0100330203001000",
    "0100303203001000"
  ]
}
