{
  "puzzle_info": {
    "grid_width": 4,
    "grid_height": 4,
    "steps_to_solve": 13
  },
  "solution_path": [
    "0404000000000200",
    "0004000004000200",
    "4000000004000200",
    "4000000040000200",
    "4000400000000200",
    "4000400000002000",
    "4000400020000000",
    "4000000420000000",
    "0000400420000000",
    "0000004420000000",
    "0004004020000000",
    "4000004020000000",
    "0000404020000000",
    "0000044020000000"
  ]
}
