{
  "puzzle_info": {
    "grid_width": 4,
    "grid_height": 4,
    "steps_to_solve": 12
  },
  "solution_path": [
    "1020032001030000",
    "1020030201030000",
    "1000030201030020",
    "1000003201030020",
    "1000003201032000",
    "1000000201032030",
    "1000200001032030",
    "1000000021032030",
    "1000000021030230",
    "1030000021030200",
    "1030000021300200",
    "1000003021300200",
    "1000003021030200"
  ]
}
