{
  "puzzle_info": {
    "grid_width": 5,
    "grid_height": 5,
    "steps_to_solve": 17
  },
  "solution_path": [
    "4020000000100000040100000",
    "4000000000102000040100000",
    "0000400000102000040100000",
    "0000400000100020040100000",
    "0000400002100000040100000",
    "4000000002100000040100000",
    "0000040002100000040100000",
    "0000000042100000040100000",
    "0000200040100000040100000",
    "2000000040100000040100000",
    "0000020040100000040100000",
    "0000000240100000040100000",
    "0000000200100000040100040",
    "0000000200100000040140000",
    "0000000200100004040100000",
    "0000000200100000440100000",
    "0000000200104000400100000",
    "0020000000104000400100000"
  ]
}
