{
  "puzzle_info": {
    "grid_width": 5,
    "grid_height": 5,
    "steps_to_solve": 18
  },
  "solution_path": [
    "2000000000300000200002000",
    "0000020000300000200002000",
    "0000020000000030200002000",
    "0000020000000032000002000",
    "0000020000200030000002000",
    "0000000002200030000002000",
    "0000000002230000000002000",
    "0300000002200000000002000",
    "0300000002000020000002000",
    "0300002002000020000000000",
    "0300002200000020000000000",
    "0300000200000020000002000",
    "0000000200000020300002000",
    "0000000200000020300000002",
    "0000000200000020300200000",
    "0000000200000020320000000",
    "0000000200002020300000000",
    "0000000200002200300000000",
    "0000000200000200300000200"
  ]
}
