{
  "puzzle_info": {
    "grid_width": 4,
    "grid_height": 4,
    "steps_to_solve": 13
  },
  "solution_path": [
    "0000020030000040",
    "0000020000003040",
    "0000020000003400",
    "3000020000000400",
    "0003020000000400",
    "0003020004000000",
    "0203000004000000",
    "0023000004000000",
    "0003000004000020",
    "3000000004000020",
    "3020000004000000",
    "0320000004000000",
    "0020030004000000",
    "0020300004000000"
  ]
}
