{
  "puzzle_info": {
    "grid_width": 5,
    "grid_height": 5,
    "steps_to_solve": 17
  },
  "solution_path": [
    "0004340000000030100000000",
    "0004040003000030100000000",
    "4004000003000030100000000",
    "0044000003000030100000000",
    "0004000003000030100000400",
    "0004030000000030100000400",
    "0004030000000000100000403",
    "0004030000000000100000430",
    "0004030030000000100000400",
    "0004000330000000100000400",
    "0004000300000000100000430",
    "0000000300000000104000430",
    "0000000300004000104000030",
    "0000000300004000104030000",
    "0000000300000000104030400",
    "0000000300000000104003400",
    "0000000300004000104003000",
    "0000000300000040104003000"
  ]
}
