{
  "puzzle_info": {
    "grid_width": 4,
    "grid_height": 4,
    "steps_to_solve": 12
  },
  "solution_path": [
    "0000000001020044",
    "0002000001000044",
    "0042000001000004",
    "4002000001000004",
    "4002000401000000",
    "4200000401000000",
    "0200000401004000",
    "0000020401004000",
    "0000024001004000",
    "0000204001004000",
    "0000204041000000",
    "0000024041000000",
    "0200004041000000"
  ]
}
