{
  "puzzle_info": {
    "grid_width": 4,
    "grid_height": 4,
    "steps_to_solve": 10
  },
  "solution_path": [
    "0000020420000000",
    "0000020020000004",
    "0000000220000004",
    "0000000020020004",
    "0000000022000004",
    "0000000002002004",
    "0000000002000024",
    "0020000002000004",
    "0020000002004000",
    "4020000002000000",
    "0420000002000000"
  ]
}
