{
  "puzzle_info": {
    "grid_width": 4,
    "grid_height": 4,
    "steps_to_solve": 14
  },
  "solution_path": [
    "3000042000030000",
    "0000042000033000",
    "0400002000033000",
    "4000002000033000",
    "4000302000030000",
    "0004302000030000",
    "0004320000030000",
    "0004320300000000",
    "0004323000000000",
    "0000323000000004",
    "0000303000000204",
    "0000033000000204",
    "0000033000000240",
    "0000033000400200",
    "0000030300400200"
  ]
}
