{
  "puzzle_info": {
    "grid_width": 4,
    "grid_height": 4,
    "steps_to_solve": 12
  },
  "solution_path": [
    "0040030000030000",
    "0004030000030000",
    "0000030400030000",
    "0000000400030300",
    "0000000430000300",
    "0000000430000003",
    "0000000430030000",
    "0000000433000000",
    "0000000403003000",
    "0000000403000003",
    "0000000403030000",
    "0000000403300000",
    "0000000403000030"
  ]
}
