{
  "puzzle_info": {
    "grid_width": 5,
    "grid_height": 5,
    "steps_to_solve": 19
  },
  "solution_path": [
    "0021000000000100300002040",
    "0021000000000103000002040",
    "0021000000000103000002400",
    "0001000000000103020002400",
    "0201000000000103020000400",
    "2001000000000103020000400",
    "2001000000000103200000400",
    "2001030000000100200000400",
    "0021030000000100200000400",
    "0021000003000100200000400",
    "0021000403000100200000000",
    "0021000430000100200000000",
    "0021000030000100200000400",
    "0001000030000100220000400",
    "0001000030000100220000004",
    "0001400030000100220000000",
    "0001400030000100200200000",
    "0001000030000140200200000",
    "0001000030000140220000000",
    "0001000030000142020000000"
  ]
}
