{
  "puzzle_info": {
    "grid_width": 4,
    "grid_height": 4,
    "steps_to_solve": 12
  },
  "solution_path": [
    "0000000022044000",
    "2000000002044000",
    "2000000020044000",
    "0000200020044000",
    "0000200000244000",
    "0000200000204004",
    "0000200000204400",
    "0000200040200400",
    "0000000240200400",
    "0400000240200000",
    "0400000204200000",
    "0000040204200000",
    "0000040200200400"
  ]
}
