{
  "puzzle_info": {
    "grid_width": 4,
    "grid_height": 4,
    "steps_to_solve": 11
  },
  "solution_path": [
    "0200000100042001",
    "0200000140002001",
    "0200000140000021",
    "0200000100004021",
    "0200000100000421",
    "0000000102000421",
    "0020000102000401",
    "2000000102000401",
    "2000000102000041",
    "2040000102000001",
    "0240000102000001",
    "0204000102000001"
  ]
}
