{
  "puzzle_info": {
    "grid_width": 4,
    "grid_height": 4,
    "steps_to_solve": 11
  },
  "solution_path": [
    "0003120000000000",
    "0003100000000200",
    "0003100000000002",
    "0000100000030002",
    "0000100000032000",
    "0000100020030000",
    "0000100000230000",
    "0000100000200003",
    "0000100000203000",
    "0000100030200000",
    "0000100003200000",
    "0020100003000000"
  ]
}
