{
  "puzzle_info": {
    "grid_width": 4,
    "grid_height": 4,
    "steps_to_solve": 12
  },
  "solution_path": [
    "0000003202300000",
    "0000300202300000",
    "0002300002300000",
    "0002300002030000",
    "0002300000230000",
    "0002300300200000",
    "0002330000200000",
    "0302300000200000",
    "0320300000200000",
    "0020300000200300",
    "0000302000200300",
    "0000032000200300",
    "0020030000200300"
  ]
}
