{
  "puzzle_info": {
    "grid_width": 4,
    "grid_height": 4,
    "steps_to_solve": 12
  },
  "solution_path": [
    "0000000030030002",
    "0000000033000002",
    "0000000003003002",
    "0002000003003000",
    "0002000003000003",
    "0000000003020003",
    "0000000003200003",
    "0300000000200003",
    "0303000000200000",
    "0330000000200000",
    "0030000000200300",
    "0000003000200300",
    "0000003020000300"
  ]
}
