{
  "puzzle_info": {
    "grid_width": 5,
    "grid_height": 5,
    "steps_to_solve": 16
  },
  "solution_path": [
    "0100000000002000030000040",
    "0100000000002000000300040",
    "0100000000000000000300240",
    "0100300000000000000000240",
    "0104300000000000000000200",
    "0140300000000000000000200",
    "0100300000000000040000200",
    "0130000000000000040000200",
    "0100000000003000040000200",
    "0100000000003004000000200",
    "0100000000003004020000000",
    "0100000000003000420000000",
    "0100000000003000400200000",
    "0100200000003000400000000",
    "0120000000003000400000000",
    "0100000200003000400000000",
    "0100000200000030400000000"
  ]
}
