{
  "puzzle_info": {
    "grid_width": 4,
    "grid_height": 4,
    "steps_to_solve": 10
  },
  "solution_path": [
    "0211000000020000",
    "0011000000020200",
    "0011000020000200",
    "2011000000000200",
    "0211000000000200",
    "0011000002000200",
    "0011000002002000",
    "2011000002000000",
    "0211000002000000",
    "0011020002000000",
    "0011020020000000"
  ]
}
