{
  "puzzle_info": {
    "grid_width": 4,
    "grid_height": 4,
    "steps_to_solve": 10
  },
  "solution_path": [
    "0001400000341400",
    "0001000040341400",
    "0001000043041400",
    "0001000043401400",
    "0301000040401400",
    "3001000040401400",
    "3401000040401000",
    "3041000040401000",
    "3001004040401000",
    "3001004004401000",
    "3001004004001040"
  ]
}
