{
  "puzzle_info": {
    "grid_width": 4,
    "grid_height": 4,
    "steps_to_solve": 13
  },
  "solution_path": [
    "0300000000003414",
    "0000000003003414",
    "0004000003003410",
    "4000000003003410",
    "4300000000003410",
    "4300300000000410",
    "4300000300000410",
    "0300000300004410",
    "0300040300004010",
    "0300040300000410",
    "0300040304000010",
    "0300004304000010",
    "0000034304000010",
    "0000304304000010"
  ]
}
