{
  "puzzle_info": {
    "grid_width": 4,
    "grid_height": 4,
    "steps_to_solve": 10
  },
  "solution_path": [
    "3004000001000000",
    "0004000001003000",
    "4000000001003000",
    "4000300001000000",
    "0004300001000000",
    "0000300001000004",
    "0000000301000004",
    "0000000301040000",
    "0000300001040000",
    "0000300001400000",
    "0040300001000000"
  ]
}
