{
  "puzzle_info": {
    "grid_width": 5,
    "grid_height": 5,
    "steps_to_solve": 15
  },
  "solution_path": [
    "0000000110302000000030000",
    "0000000110032000000030000",
    "0000000110030020000030000",
    "0000200110030000000030000",
    "0000200110030000000000003",
    "0000200110000000000003003",
    "0000200110000000000003300",
    "0300200110000000000000300",
    "0003200110000000000000300",
    "0003000110000000000000302",
    "0003000110000000000000320",
    "0003000110000200000000300",
    "0003000110200000000000300",
    "0003000110203000000000000",
    "0003000110023000000000000",
    "0003000110020030000000000"
  ]
}
