{
  "puzzle_info": {
    "grid_width": 4,
    "grid_height": 4,
    "steps_to_solve": 12
  },
  "solution_path": [
    "4000430000400000",
    "0004430000400000",
    "0004430000040000",
    "0000430400040000",
    "0000403400040000",
    "0000043400040000",
    "0000040400040030",
    "0000044000040030",
    "0400004000040030",
    "0400004040000030",
    "0400004040300000",
    "0400004004300000",
    "0400004004030000"
  ]
}
