{
  "puzzle_info": {
    "grid_width": 4,
    "grid_height": 4,
    "steps_to_solve": 12
  },
  "solution_path": [
    "0000020400031300",
    "0000002400031300",
    "0000000400031320",
    "0004000000031320",
    "0304000000031020",
    "0340000000031020",
    "0300000000431020",
    "0303000000401020",
    "0033000000401020",
    "0003003000401020",
    "3000003000401020",
    "0000003030401020",
    "0000003003401020"
  ]
}
