{
  "puzzle_info": {
    "grid_width": 5,
    "grid_height": 5,
    "steps_to_solve": 18
  },
  "solution_path": [
    "0400400020000000000000300",
    "0440000020000000000000300",
    "0040000020000000000004300",
    "0040000000000000000004320",
    "0040000300000000000004020",
    "0040000300000000000000420",
    "0040000300004000000000020",
    "0040030000004000000000020",
    "0000030400004000000000020",
    "0000030400004000000020000",
    "0000030400204000000000000",
    "0000003400204000000000000",
    "0000000400204000000003000",
    "0000000400024000000003000",
    "0000000400020040000003000",
    "0000000400020040300000000",
    "0000000400000240300000000",
    "0000000400000200300000004",
    "0000000400000200300040000"
  ]
}
