{
  "puzzle_info": {
    "grid_width": 4,
    "grid_height": 4,
    "steps_to_solve": 12
  },
  "solution_path": [
    "0001000420001430",
    "0001400020001430",
    "0001400000021430",
    "0001400200001430",
    "0001420000001430",
    "0001020040001430",
    "0001020000041430",
    "0001020004041030",
    "0001020000441030",
    "0001020000441300",
    "0001020003441000",
    "0001200003441000",
    "0001000023441000"
  ]
}
