{
  "puzzle_info": {
    "grid_width": 4,
    "grid_height": 4,
    "steps_to_solve": 12
  },
  "solution_path": [
    "0004030000020000",
    "0004030200000000",
    "0004032000000000",
    "0000032000000004",
    "0000002000000304",
    "0000002000000340",
    "0000002000003040",
    "0000002000403000",
    "0000200000403000",
    "0000200030400000",
    "0000000230400000",
    "0000000203400000",
    "0040000203000000"
  ]
}
