{
  "puzzle_info": {
    "grid_width": 4,
    "grid_height": 4,
    "steps_to_solve": 13
  },
  "solution_path": [
    "3003400000000040",
    "0033400000000040",
    "0003400000300040",
    "0003000000304040",
    "0003000000304400",
    "0403000000304000",
    "0430000000304000",
    "4030000000304000",
    "0030000040304000",
    "0030000004304000",
    "4030000004300000",
    "0430000004300000",
    "0400003004300000",
    "0400003004000030"
  ]
}
