{
  "puzzle_info": {
    "grid_width": 4,
    "grid_height": 4,
    "steps_to_solve": 10
  },
  "solution_path": [
    "2000000000200010",
    "2020000000000010",
    "2200000000000010",
    "0200000000002010",
    "0200000000000210",
    "0200020000000010",
    "2000020000000010",
    "0000020000002010",
    "0000020000000210",
    "0000020002000010",
    "0000020000020010"
  ]
}
