{
  "puzzle_info": {
    "grid_width": 4,
    "grid_height": 4,
    "steps_to_solve": 14
  },
  "solution_path": [
    "3000200000004300",
    "3000000020004300",
    "3000000000024300",
    "0000000030024300",
    "0000000000324300",
    "0300000000324000",
    "3000000000324000",
    "0000000030324000",
    "0000000003324000",
    "0030000003024000",
    "0030000003204000",
    "4030000003200000",
    "0430000003200000",
    "0400003003200000",
    "0400003003020000"
  ]
}
