{
  "puzzle_info": {
    "grid_width": 4,
    "grid_height": 4,
    "steps_to_solve": 10
  },
  "solution_path": [
    "0110003003030200",
    "0110300003030200",
    "0110300003000203",
    "0110300003000023",
    "0110302003000003",
    "0110032003000003",
    "0110032003003000",
    "0110030003003020",
    "0110030003000320",
    "0110030003000302",
    "0112030003000300"
  ]
}
