{
  "puzzle_info": {
    "grid_width": 4,
    "grid_height": 4,
    "steps_to_solve": 14
  },
  "solution_path": [
    "4010100032000000",
    "0410100032000000",
    "0010140032000000",
    "0010100432000000",
    "0010100032000004",
    "0010100002003004",
    "0010100000003204",
    "0010100000003240",
    "0210100000003040",
    "2010100000003040",
    "2010100000000340",
    "2010104000000300",
    "2010140000000300",
    "2010140003000000",
    "2410100003000000"
  ]
}
