{
  "puzzle_info": {
    "grid_width": 5,
    "grid_height": 5,
    "steps_to_solve": 16
  },
  "solution_path": [
    "0002000000000120200030000",
    "2000000000000120200030000",
    "2000000000000120000032000",
    "2000030000000120000002000",
    "0000230000000120000002000",
    "0000030002000120000002000",
    "0000032000000120000002000",
    "0000002000000120000032000",
    "0000002000000100000032002",
    "0000002000000100000032200",
    "0000002000020100000030200",
    "0000002000020100000003200",
    "0000002000020100300000200",
    "0000002000002100300000200",
    "0000002000000100320000200",
    "0000002000000100300200200",
    "0020002000000100300200000"
  ]
}
