{
  "puzzle_info": {
    "grid_width": 4,
    "grid_height": 4,
    "steps_to_solve": 10
  },
  "solution_path": [
    "0400100001000020",
    "0004100001000020",
    "0004100001000002",
    "0000100001040002",
    "0000100001400002",
    "0002100001400000",
    "0002100001040000",
    "0000100201040000",
    "0000120001040000",
    "0200100001040000",
    "0200100001400000"
  ]
}
