{
  "puzzle_info": {
    "grid_width": 5,
    "grid_height": 5,
    "steps_to_solve": 17
  },
  "solution_path": [
    "0200000000040000010003300",
    "0000002000040000010003300",
    "0000002000040000010003003",
    "0000302000040000010003000",
    "0000302000000040010003000",
    "0000002003000040010003000",
    "0000002300000040010003000",
    "0000002300000040010000003",
    "0000000300000040010002003",
    "0000000300000040010000023",
    "0000000300000040010300020",
    "0000000300400000010300020",
    "0000000300000000010340020",
    "0000000300000000010300420",
    "0002000300000000010300400",
    "0002000300000000013000400",
    "0000000300000200013000400",
    "0000000300000200010300400"
  ]
}
