{
  "puzzle_info": {
    "grid_width": 4,
    "grid_height": 4,
    "steps_to_solve": 13
  },
  "solution_path": [
    "0000002000033000",
    "0000000000033020",
    "0000000000003023",
    "0000000000003203",
    "0200000000003003",
    "0200000000000033",
    "0203000000000030",
    "0230000000000030",
    "0200000000300030",
    "0200000000300003",
    "0203000000300000",
    "0230000000300000",
    "0200003000300000",
    "0200000300300000"
  ]
}
