{
  "puzzle_info": {
    "grid_width": 5,
    "grid_height": 5,
    "steps_to_solve": 19
  },
  "solution_path": [
    "4000300000002000000030000",
    "0004300000002000000030000",
    "0000300000002000000030040",
    "3000000000002000000030040",
    "3000000000002000000000340",
    "3000000000002000030000040",
    "3000000000000020030000040",
    "3004000000000020030000000",
    "0034000000000020030000000",
    "0004000000003020030000000",
    "0004000000003200030000000",
    "0004000000300200030000000",
    "0004000020300000030000000",
    "4000000020300000030000000",
    "0000040020300000030000000",
    "0000000420300000030000000",
    "0000000020304000030000000",
    "0000000020034000030000000",
    "0040000020030000030000000",
    "0000400020030000030000000"
  ]
}
