{
  "puzzle_info": {
    "grid_width": 5,
    "grid_height": 5,
    "steps_to_solve": 19
  },
  "solution_path": [
    "1000000000300020000041000",
    "1000000000000023000041000",
    "1000000000200003000041000",
    "1000000000200000000341000",
    "1000000000200004000301000",
    "1000020000000004000301000",
    "1000000002000004000301000",
    "1000000002000000004301000",
    "1000000002000030004001000",
    "1000000002300000004001000",
    "1000030002000000004001000",
    "1000000032000000004001000",
    "1000200030000000004001000",
    "1200000030000000004001000",
    "1000000030000000204001000",
    "1000000030000002004001000",
    "1000020030000000004001000",
    "1000000230000000004001000",
    "1000000200000300004001000",
    "1000000200000300000001040"
  ]
}
