{
  "puzzle_info": {
    "grid_width": 4,
    "grid_height": 4,
    "steps_to_solve": 10
  },
  "solution_path": [
    "0000001000040003",
    "0000001000043000",
    "0000001000003004",
    "0000001000000034",
    "0000001000300004",
    "0000001000304000",
    "0000001000004030",
    "0000001000000430",
    "0400001000000030",
    "0400001000300000",
    "0400001000030000"
  ]
}
