{
  "puzzle_info": {
    "grid_width": 4,
    "grid_height": 4,
    "steps_to_solve": 12
  },
  "solution_path": [
    "0102004210000000",
    "0120004210000000",
    "0120000210000040",
    "0100000210200040",
    "0100200010200040",
    "2100000010200040",
    "2100000010200004",
    "2104000010200000",
    "2140000010200000",
    "2100004010200000",
    "2100004012000000",
    "2100024010000000",
    "2100204010000000"
  ]
}
