{
  "puzzle_info": {
    "grid_width": 4,
    "grid_height": 4,
    "steps_to_solve": 11
  },
  "solution_path": [
    "0030000000003300",
    "3030000000000300",
    "3300000000000300",
    "3000000003000300",
    "3000000003003000",
    "3000300003000000",
    "0003300003000000",
    "0000300003000003",
    "0000000303000003",
    "0000000303030000",
    "0000000303300000",
    "0000000330300000"
  ]
}
