{
  "puzzle_info": {
    "grid_width": 4,
    "grid_height": 4,
    "steps_to_solve": 11
  },
  "solution_path": [
    "2000030002000000",
    "0002030002000000",
    "0002030000020000",
    "0000030200020000",
    "0000003200020000",
    "0000003200000002",
    "0000003200002000",
    "0000003000002002",
    "0000003000000022",
    "0000003000200002",
    "0000003000202000",
    "0000003000002020"
  ]
}
