{
  "puzzle_info": {
    "grid_width": 5,
    "grid_height": 5,
    "steps_to_solve": 21
  },
  "solution_path": [
    "0000000000200402000000001",
    "0000000000002402000000001",
    "0004000000002002000000001",
    "2004000000002000000000001",
    "0024000000002000000000001",
    "0004000200002000000000001",
    "0000400200002000000000001",
    "0000000200002000000400001",
    "0000000200000020000400001",
    "0000000200000024000000001",
    "0000000200000004000200001",
    "0000000200000004200000001",
    "4000000200000000200000001",
    "0000400200000000200000001",
    "0000000200000000200400001",
    "0000000200000000240000001",
    "0200000200000000040000001",
    "0000200200000000040000001",
    "0000000200000000040200001",
    "0000000200000000042000001",
    "0000000200004000002000001",
    "0000000002004000002000001"
  ]
}
