{
  "puzzle_info": {
    "grid_width": 5,
    "grid_height": 5,
    "steps_to_solve": 16
  },
  "solution_path": [
    "0000000003000000000000022",
    "0000000000000000000300022",
    "0002000000000000000300002",
    "0000200000000000000300002",
    "0000000000000020000300002",
    "0000000000000023000000002",
    "0000000000000023000200000",
    "0000000000200003000200000",
    "0000000000200000003200000",
    "0000000000200000003000002",
    "0000000000200000003020000",
    "0000000000200002003000000",
    "0000000000200000023000000",
    "0003000000200000020000000",
    "3000000000200000020000000",
    "0000030000200000020000000",
    "0000030000000020020000000"
  ]
}
