{
  "puzzle_info": {
    "grid_width": 4,
    "grid_height": 4,
    "steps_to_solve": 12
  },
  "solution_path": [
    "2220000040000000",
    "2200000040000020",
    "2002000040000020",
    "0022000040000020",
    "0002000040200020",
    "4002000000200020",
    "0042000000200020",
    "0002004000200020",
    "2000004000200020",
    "2000004020000020",
    "0000204020000020",
    "0000024020000020",
    "0000024020200000"
  ]
}
