{
  "puzzle_info": {
    "grid_width": 5,
    "grid_height": 5,
    "steps_to_solve": 10
  },
  "solution_path": [
    "0031031000000000000000000",
    "0001031000000000000000300",
    "3001001000000000000000300",
    "0031001000000000000000300",
    "0001001000000000030000300",
    "0001001000000000030030000",
    "3001001000000000030000000",
    "0031001000000000030000000",
    "0001001000003000030000000",
    "0001001000003000000000300",
    "0001001000003000000030000"
  ]
}
