{
  "puzzle_info": {
    "grid_width": 4,
    "grid_height": 4,
    "steps_to_solve": 14
  },
  "solution_path": [
    "4402000000000003",
    "0402000000004003",
    "0402000000004300",
    "0002000004004300",
    "4002000004000300",
    "0042000004000300",
    "0002000004000340",
    "2000000004000340",
    "2040000004000300",
    "0240000004000300",
    "0040020004000300",
    "0040020000040300",
    "0040020003040000",
    "0040020003400000",
    "0040020000400300"
  ]
}
