{
  "puzzle_info": {
    "grid_width": 4,
    "grid_height": 4,
    "steps_to_solve": 11
  },
  "solution_path": [
    "0400030000001000",
    "4000030000001000",
    "4000300000001000",
    "4000000030001000",
    "4000000000031000",
    "0000000040031000",
    "0000000000431000",
    "0003000000401000",
    "3000000000401000",
    "0000000030401000",
    "0000000003401000",
    "0000000003041000"
  ]
}
