{
  "puzzle_info": {
    "grid_width": 4,
    "grid_height": 4,
    "steps_to_solve": 13
  },
  "solution_path": [
    "0423000000000000",
    "0023000000000400",
    "0020000000000403",
    "0020000000000430",
    "0020003000000400",
    "0002003000000400",
    "0000003000000402",
    "0000003000000420",
    "0000003000004020",
    "0000003000204000",
    "0000300000204000",
    "0000300040200000",
    "0000300004200000",
    "0000300004020000"
  ]
}
