{
  "puzzle_info": {
    "grid_width": 4,
    "grid_height": 4,
    "steps_to_solve": 13
  },
  "solution_path": [
    "0000000000402203",
    "2000000000400203",
    "2003000000400200",
    "0023000000400200",
    "0020000000400203",
    "0020004000000203",
    "0020004000000230",
    "0020004000002030",
    "0020004000302000",
    "0020400000302000",
    "0000402000302000",
    "0000402020300000",
    "0000042020300000",
    "0000040220300000"
  ]
}
