{
  "puzzle_info": {
    "grid_width": 5,
    "grid_height": 5,
    "steps_to_solve": 17
  },
  "solution_path": [
    "0020000003000001000003000",
    "2000000003000001000003000",
    "0000000003200001000003000",
    "0000000003200001000000003",
    "0000000003200031000000000",
    "0000030000200031000000000",
    "0000030000000231000000000",
    "0000000000300231000000000",
    "0000000000003231000000000",
    "0000000000003031000000020",
    "0000000000003301000000020",
    "0000000000003001003000020",
    "0000000000003001003000002",
    "0000200000003001003000000",
    "2000000000003001003000000",
    "0000000000203001003000000",
    "0000000000023001003000000",
    "0000000000020031003000000"
  ]
}
