{
  "puzzle_info": {
    "grid_width": 4,
    "grid_height": 4,
    "steps_to_solve": 12
  },
  "solution_path": [
    "1030000400300000",
    "1300000400300000",
    "1000000400300300",
    "1004000000300300",
    "1400000000300300",
    "1000000004300300",
    "1030000004000300",
    "1300000004000300",
    "1000030004000300",
    "1000030000040300",
    "1000030003040000",
    "1000030003400000",
    "1000030000400300"
  ]
}
