{
  "puzzle_info": {
    "grid_width": 5,
    "grid_height": 5,
    "steps_to_solve": 17
  },
  "solution_path": [
    "0000200004010000030000100",
    "0000240000010000030000100",
    "0000040000010000030000102",
    "0000000004010000030000102",
    "0030000004010000000000102",
    "0030000004010020000000100",
    "0030000004012000000000100",
    "0030000204010000000000100",
    "0000300204010000000000100",
    "0000300240010000000000100",
    "0000000240010000000000103",
    "0000000240010000000000130",
    "0000000240010300000000100",
    "0000000204010300000000100",
    "0000000200010300000000104",
    "0000000200010300000000140",
    "0000000200010300004000100",
    "0000000200010300000400100"
  ]
}
