{
  "puzzle_info": {
    "grid_width": 4,
    "grid_height": 4,
    "steps_to_solve": 13
  },
  "solution_path": [
    "1040000300000000",
    "1000000300000040",
    "1000000000000043",
    "1000000000004003",
    "1000400000000003",
    "1000000400000003",
    "1000000400003000",
    "1000300400000000",
    "1000003400000000",
    "1000003000000004",
    "1000003000004000",
    "1000403000000000",
    "1000043000000000",
    "1000040300000000"
  ]
}
