{
  "puzzle_info": {
    "grid_width": 5,
    "grid_height": 5,
    "steps_to_solve": 15
  },
  "solution_path": [
    "0000000000000000004020200",
    "0004000000000000000020200",
    "0004000000000000000002200",
    "0204000000000000000000200",
    "0240000000000000000000200",
    "0200000000000000040000200",
    "0000200000000000040000200",
    "0000200000000000040000002",
    "0000000000000000040200002",
    "0000000000000000042000002",
    "0040000000000000002000002",
    "0040200000000000002000000",
    "0042000000000000002000000",
    "0002000000000000002000400",
    "0000000000000200002000400",
    "0000000000000200000200400"
  ]
}
