{
  "puzzle_info": {
    "grid_width": 4,
    "grid_height": 4,
    "steps_to_solve": 12
  },
  "solution_path": [
    "2000000000302000",
    "0000000020302000",
    "0000000002302000",
    "0030000002002000",
    "2030000002000000",
    "2300000002000000",
    "0300000002002000",
    "0000030002002000",
    "0000030002000002",
    "0000030000000202",
    "0000030000000220",
    "0000030002000020",
    "0000300002000020"
  ]
}
