{
  "puzzle_info": {
    "grid_width": 4,
    "grid_height": 4,
    "steps_to_solve": 10
  },
  "solution_path": [
    "0303030000000000",
    "0033030000000000",
    "0003030000000030",
    "0303000000000030",
    "0330000000000030",
    "0300000000300030",
    "0300000000300003",
    "0303000000300000",
    "0330000000300000",
    "0300003000300000",
    "0300003030000000"
  ]
}
