{
  "puzzle_info": {
    "grid_width": 4,
    "grid_height": 4,
    "steps_to_solve": 13
  },
  "solution_path": [
    "0304002000004000",
    "3004002000004000",
    "0004002030004000",
    "0004200030004000",
    "0004200030000004",
    "0004200430000000",
    "0004240030000000",
    "0004240000030000",
    "0000240400030000",
    "0000244000030000",
    "0000204000030400",
    "0000024000030400",
    "0000024004030000",
    "0200004004030000"
  ]
}
