{
  "puzzle_info": {
    "grid_width": 4,
    "grid_height": 4,
    "steps_to_solve": 13
  },
  "solution_path": [
    "0000000000044002",
    "0004000000004002",
    "0004000200004000",
    "0004000200000004",
    "0004000000020004",
    "0000000400020004",
    "0000000420000004",
    "0000000420040000",
    "0000000424000000",
    "0000000404002000",
    "0000000404000002",
    "0000000404020000",
    "0000000404200000",
    "0000000404000020"
  ]
}
