{
  "puzzle_info": {
    "grid_width": 4,
    "grid_height": 4,
    "steps_to_solve": 12
  },
  "solution_path": [
    "2020200000003000",
    "2020000020003000",
    "2020000000023000",
    "0020000020023000",
    "0020000000223000",
    "0000002000223000",
    "0000002000023020",
    "3000002000020020",
    "3000002020000020",
    "0000302020000020",
    "0000302020200000",
    "0000302002200000",
    "0000302002020000"
  ]
}
