{
  "puzzle_info": {
    "grid_width": 5,
    "grid_height": 5,
    "steps_to_solve": 17
  },
  "solution_path": [
    "0044142000000000000010000",
    "0004142000000000000010400",
    "0000142000000000000010440",
    "4000102000000000000010440",
    "0004102000000000000010440",
    "0000102000000000004010440",
    "0200100000000000004010440",
    "0200100000000000004014040",
    "0200104000000000004010040",
    "0002104000000000004010040",
    "0000104000000200004010040",
    "0000104000000200004014000",
    "0000104000000200000014040",
    "0000104000040200000010040",
    "0400100000040200000010040",
    "0400100000040200000014000",
    "0400100000040200400010000",
    "0400104000000200400010000"
  ]
}
