{
  "puzzle_info": {
    "grid_width": 4,
    "grid_height": 4,
    "steps_to_solve": 12
  },
  "solution_path": [
    "0044200000200000",
    "0040200000200004",
    "0004200000200004",
    "0000200000240004",
    "0000200000244000",
    "0000000020244000",
    "0000000002244000",
    "0020000002044000",
    "0020000002404000",
    "4020000002400000",
    "0420000002400000",
    "0400002002400000",
    "0400002002040000"
  ]
}
