{
  "puzzle_info": {
    "grid_width": 4,
    "grid_height": 4,
    "steps_to_solve": 12
  },
  "solution_path": [
    "1100000000002222",
    "1100200000000222",
    "1100000200000222",
    "1100020200000022",
    "1100002200000022",
    "1100000200200022",
    "1100000200220020",
    "1102000000220020",
    "1120000000220020",
    "1100002000220020",
    "1100002020020020",
    "1100002020220000",
    "1100002022020000"
  ]
}
