{
  "puzzle_info": {
    "grid_width": 4,
    "grid_height": 4,
    "steps_to_solve": 13
  },
  "solution_path": [
    "0030000000000440",
    "3000000000000440",
    "3000000000004040",
    "3000400000000040",
    "3000400000004000",
    "3000000040004000",
    "0000300040004000",
    "0000300000044000",
    "0000300040040000",
    "0000300000440000",
    "0000300000400004",
    "0000300000404000",
    "0000300040400000",
    "0000300004400000"
  ]
}
