{
  "puzzle_info": {
    "grid_width": 4,
    "grid_height": 4,
    "steps_to_solve": 12
  },
  "solution_path": [
    "0000000400020010",
    "0004000000020010",
    "0004000020000010",
    "2004000000000010",
    "2400000000000010",
    "0400000000002010",
    "0400000000000210",
    "0400020000000010",
    "4000020000000010",
    "0000020000004010",
    "0000020000000410",
    "0000020004000010",
    "0000020000040010"
  ]
}
