{
  "puzzle_info": {
    "grid_width": 4,
    "grid_height": 4,
    "steps_to_solve": 12
  },
  "solution_path": [
    "0400200000044010",
    "0000200000044410",
    "2000000000044410",
    "0002000000044410",
    "0002000400004410",
    "4002000400000410",
    "4200000400000410",
    "0200000400004410",
    "0200040400004010",
    "0200044000004010",
    "0200044000000410",
    "0200044004000010",
    "0200404004000010"
  ]
}
