{
  "puzzle_info": {
    "grid_width": 4,
    "grid_height": 4,
    "steps_to_solve": 12
  },
  "solution_path": [
    "3041002000000130",
    "0341002000000130",
    "0341000000200130",
    "0341000000200103",
    "0341000300200100",
    "0341300000200100",
    "0301304000200100",
    "0301340000200100",
    "0301340000020100",
    "0301340200000100",
    "0301342000000100",
    "0301302004000100",
    "0301032004000100"
  ]
}
