{
  "puzzle_info": {
    "grid_width": 5,
    "grid_height": 5,
    "steps_to_solve": 20
  },
  "solution_path": [
    "0000000004100030000030000",
    "0000000004100000000030003",
    "0000000000100000000430003",
    "0000000000100003000400003",
    "0000000000100000003400003",
    "0000000000100000003430000",
    "0000000000100003003400000",
    "0000000000100000033400000",
    "0000000000100000030400030",
    "0000000000100000034000030",
    "0004000000100000030000030",
    "0004000030100000030000000",
    "4000000030100000030000000",
    "0000040030100000030000000",
    "0000000430100000030000000",
    "0000000400100000030000030",
    "0000000400100000030030000",
    "0000000400100003030000000",
    "0000000400100000330000000",
    "0000000400103000300000000",
    "0040000000103000300000000"
  ]
}
