{
  "puzzle_info": {
    "grid_width": 4,
    "grid_height": 4,
    "steps_to_solve": 12
  },
  "solution_path": [
    "1000201004000003",
    "1000001004002003",
    "1003001004002000",
    "1003001000042000",
    "1003001400002000",
    "1300001400002000",
    "1300001400000002",
    "1000001400000302",
    "1000001400000032",
    "1000001400300002",
    "1000001400302000",
    "1000201400300000",
    "1000021400300000"
  ]
}
