{
  "puzzle_info": {
    "grid_width": 4,
    "grid_height": 4,
    "steps_to_solve": 12
  },
  "solution_path": [
    "3400000000000300",
    "3400000000000003",
    "3000000000000403",
    "3000000000000430",
    "3030000000000400",
    "0330000000000400",
    "0030000003000400",
    "0030000003004000",
    "4030000003000000",
    "0430000003000000",
    "0030040003000000",
    "0000040003000030",
    "0000040000030030"
  ]
}
