{
  "puzzle_info": {
    "grid_width": 4,
    "grid_height": 4,
    "steps_to_solve": 13
  },
  "solution_path": [
    "1000030402100400",
    "1000003402100400",
    "1004003002100400",
    "1400003002100400",
    "1400003002100004",
    "1400003000100204",
    "1400003000100024",
    "1404003000100020",
    "1440003000100020",
    "1040003000100420",
    "1040003000104020",
    "1040403000100020",
    "1040043000100020",
    "1040040300100020"
  ]
}
