{
  "puzzle_info": {
    "grid_width": 4,
    "grid_height": 4,
    "steps_to_solve": 12
  },
  "solution_path": [
    "0320200200000000",
    "0020200200000300",
    "0020220000000300",
    "2020020000000300",
    "0220020000000300",
    "0202020000000300",
    "0202000002000300",
    "0202000002000003",
    "0200000002020003",
    "0200000002200003",
    "0203000002200000",
    "0230000002200000",
    "0200003002200000"
  ]
}
