{
  "puzzle_info": {
    "grid_width": 4,
    "grid_height": 4,
    "steps_to_solve": 12
  },
  "solution_path": [
    "0000000042000004",
    "0200000040000004",
    "2000000040000004",
    "0000200040000004",
    "0004200040000000",
    "0004200000040000",
    "0000200400040000",
    "0000240000040000",
    "2000040000040000",
    "0002040000040000",
    "0000040200040000",
    "0000042000040000",
    "0000040000040020"
  ]
}
