{
  "puzzle_info": {
    "grid_width": 4,
    "grid_height": 4,
    "steps_to_solve": 12
  },
  "solution_path": [
    "0000010202000240",
    "0000012002000240",
    "0020010002000240",
    "0020010000020240",
    "0020010000022040",
    "0020010000022400",
    "2020010000020400",
    "0220010000020400",
    "0202010000020400",
    "0200010200020400",
    "0200010204020000",
    "0200010204200000",
    "0200010240200000"
  ]
}
