{
  "puzzle_info": {
    "grid_width": 4,
    "grid_height": 4,
    "steps_to_solve": 11
  },
  "solution_path": [
    "0000024000002020",
    "0000204000002020",
    "0000004020002020",
    "0040000020002020",
    "0040000020000220",
    "0040002020000200",
    "4000002020000200",
    "0000402020000200",
    "0000042020000200",
    "0000042000020200",
    "0000042002020000",
    "0400002002020000"
  ]
}
