{
  "puzzle_info": {
    "grid_width": 4,
    "grid_height": 4,
    "steps_to_solve": 10
  },
  "solution_path": [
    "0040100004000000",
    "0000100004000040",
    "0000100000040040",
    "0000100000044000",
    "0000100040040000",
    "0000100000440000",
    "0000100000400004",
    "0000100000404000",
    "0000100040400000",
    "0000100004400000",
    "0000100004040000"
  ]
}
