{
  "puzzle_info": {
    "grid_width": 4,
    "grid_height": 4,
    "steps_to_solve": 13
  },
  "solution_path": [
    "4000202000003100",
    "0004202000003100",
    "0000202000003104",
    "0000022000003104",
    "0020020000003104",
    "3020020000000104",
    "0320020000000104",
    "0302020000000104",
    "0302020400000100",
    "0320020400000100",
    "0300020400000120",
    "0300024000000120",
    "0300024000200100",
    "0300020400200100"
  ]
}
