{
  "puzzle_info": {
    "grid_width": 5,
    "grid_height": 5,
    "steps_to_solve": 18
  },
  "solution_path": [
    "0000003102200000000000040",
    "0300000102200000000000040",
    "0300200100200000000000040",
    "0003200100200000000000040",
    "0003000100200000000000042",
    "2003000100000000000000042",
    "0023000100000000000000042",
    "0020000100000000003000042",
    "0020000100000000003040002",
    "0020000100000000003042000",
    "4020000100000000003002000",
    "0420000100000000003002000",
    "0020000100000000403002000",
    "0020000100000000403000002",
    "0020200100000000403000000",
    "0022000100000000403000000",
    "0020000100000200403000000",
    "0020000100000200430000000",
    "0020000100000204030000000"
  ]
}
