{
  "puzzle_info": {
    "grid_width": 4,
    "grid_height": 4,
    "steps_to_solve": 12
  },
  "solution_path": [
    "4003003300000000",
    "4300003300000000",
    "4000003300000300",
    "0004003300000300",
    "0004003000000303",
    "0004003000000330",
    "0004000000300330",
    "0304000000300030",
    "0340000000300030",
    "0300004000300030",
    "0300004030000030",
    "0300004030300000",
    "0300004003300000"
  ]
}
