{
  "puzzle_info": {
    "grid_width": 4,
    "grid_height": 4,
    "steps_to_solve": 13
  },
  "solution_path": [
    "0002000400002000",
    "2000000400002000",
    "2000400000002000",
    "2000000040002000",
    "2000000000042000",
    "2000200000040000",
    "0002200000040000",
    "0000200200040000",
    "0000220000040000",
    "2000020000040000",
    "0002020000040000",
    "0000020200040000",
    "0000022000040000",
    "0000002000040200"
  ]
}
