{
  "puzzle_info": {
    "grid_width": 5,
    "grid_height": 5,
    "steps_to_solve": 9
  },
  "solution_path": [
    "2000000000000000000020000",
    "0000200000000000000020000",
    "0000000000000000000020002",
    "0000000000000000000000022",
    "0002000000000000000000002",
    "0002000000000000000020000",
    "0000000000000000000020020",
    "0000000000000000000000220",
    "0002000000000000000000200",
    "0000200000000000000000200"
  ]
}
