{
  "puzzle_info": {
    "grid_width": 4,
    "grid_height": 4,
    "steps_to_solve": 13
  },
  "solution_path": [
    "0040000302000000",
    "0040000002000003",
    "0040000000000203",
    "0040000000000023",
    "0040002000000003",
    "0040002000003000",
    "3040002000000000",
    "3400002000000000",
    "0400002000003000",
    "0400002000000003",
    "0000002000000403",
    "0000002000000430",
    "0000002000300400",
    "0000000200300400"
  ]
}
