{
  "puzzle_info": {
    "grid_width": 4,
    "grid_height": 4,
    "steps_to_solve": 12
  },
  "solution_path": [
    "3004000043000000",
    "0034000043000000",
    "0004000043000030",
    "0304000040000030",
    "0034000040000030",
    "0004000040300030",
    "4000000040300030",
    "4000000004300030",
    "4030000004000030",
    "0430000004000030",
    "0430003004000000",
    "0403003004000000",
    "0400003004000003"
  ]
}
