{
  "puzzle_info": {
    "grid_width": 5,
    "grid_height": 5,
    "steps_to_solve": 16
  },
  "solution_path": [
    "2000000000010000040200410",
    "0000200000010000040200410",
    "0000200000010000004200410",
    "0000200002010000004000410",
    "0000220000010000004000410",
    "0040220000010000004000010",
    "0004220000010000004000010",
    "0000220000010400004000010",
    "0000220000010404000000010",
    "0000220000410400000000010",
    "2000200000410400000000010",
    "2200000000410400000000010",
    "0200020000410400000000010",
    "0200000002410400000000010",
    "0000002002410400000000010",
    "0000002200410400000000010",
    "0200000200410400000000010"
  ]
}
