{
  "puzzle_info": {
    "grid_width": 5,
    "grid_height": 5,
    "steps_to_solve": 15
  },
  "solution_path": [
    "1002200100002000000000000",
    "1002000100002000000000002",
    "1002000100000000000000202",
    "1002000100000000000000022",
    "1000000100000000002000022",
    "1000000100000000002020002",
    "1000000100000000002022000",
    "1000020100000000002002000",
    "1000002100000000002002000",
    "1000000100000000202002000",
    "1000000100000000202020000",
    "1000020100000000202000000",
    "1000002100000000202000000",
    "1000000100020000202000000",
    "1000000100020000022000000",
    "1000000100020000020200000"
  ]
}
