{
  "puzzle_info": {
    "grid_width": 4,
    "grid_height": 4,
    "steps_to_solve": 12
  },
  "solution_path": [
    "0040100000000002",
    "0000100000000042",
    "0002100000000040",
    "0002100000000004",
    "0000100000020004",
    "0000100000024000",
    "0000100040020000",
    "0000100000420000",
    "0000100000400002",
    "0000100000402000",
    "0000100020400000",
    "0000100002400000",
    "0000100002000040"
  ]
}
