{
  "puzzle_info": {
    "grid_width": 4,
    "grid_height": 4,
    "steps_to_solve": 13
  },
  "solution_path": [
    "0240000000420000",
    "0040000000420200",
    "4000000000420200",
    "4040000000020200",
    "0440000000020200",
    "0040000004020200",
    "0040000004022000",
    "2040000004020000",
    "2400000004020000",
    "2000040004020000",
    "0002040004020000",
    "0000040204020000",
    "0000040204200000",
    "0000040200200400"
  ]
}
