{
  "puzzle_info": {
    "grid_width": 4,
    "grid_height": 4,
    "steps_to_solve": 11
  },
  "solution_path": [
    "0300100000040000",
    "0003100000040000",
    "0003100000000004",
    "0000100000030004",
    "0000100000034000",
    "0000100040030000",
    "0000100000430000",
    "0000100000400003",
    "0000100000403000",
    "0000100030400000",
    "0000100003400000",
    "0000100003040000"
  ]
}
