{
  "puzzle_info": {
    "grid_width": 4,
    "grid_height": 4,
    "steps_to_solve": 10
  },
  "solution_path": [
    "2020000000000100",
    "2002000000000100",
    "0022000000000100",
    "0020000000000102",
    "0020000000000120",
    "0020002000000100",
    "0002002000000100",
    "0000002000000102",
    "0000002000000120",
    "0000002000200100",
    "0000002000020100"
  ]
}
