{
  "puzzle_info": {
    "grid_width": 4,
    "grid_height": 4,
    "steps_to_solve": 12
  },
  "solution_path": [
    "0000400002000402",
    "0200400000000402",
    "0200440000000002",
    "0002440000000002",
    "0002440200000000",
    "0002442000000000",
    "0000442000000002",
    "0000402000000402",
    "0000042000000402",
    "0000002004000402",
    "0000002004000042",
    "0002002004000040",
    "2000002004000040"
  ]
}
