{
  "puzzle_info": {
    "grid_width": 4,
    "grid_height": 4,
    "steps_to_solve": 12
  },
  "solution_path": [
    "4004000000000004",
    "0004000000004004",
    "0004000000004400",
    "0000000000004404",
    "0000000000004440",
    "0400000000004040",
    "0400000000000440",
    "0400040000000040",
    "4000040000000040",
    "0000040000004040",
    "0000040000000440",
    "0000040004000040",
    "0000040040000040"
  ]
}
