{
  "puzzle_info": {
    "grid_width": 4,
    "grid_height": 4,
    "steps_to_solve": 12
  },
  "solution_path": [
    "0032000000003000",
    "3002000000003000",
    "3002000000000003",
    "3000000000020003",
    "3000000000023000",
    "3000300000020000",
    "0003300000020000",
    "0000300300020000",
    "0000330000020000",
    "3000030000020000",
    "0003030000020000",
    "0000030300020000",
    "0000030320000000"
  ]
}
