{
  "puzzle_info": {
    "grid_width": 4,
    "grid_height": 4,
    "steps_to_solve": 13
  },
  "solution_path": [
    "0040040000000023",
    "0000040000400023",
    "0400000000400023",
    "0403000000400020",
    "0403000000400002",
    "0403000200400000",
    "0430000200400000",
    "0030000200400400",
    "0030200000400400",
    "0000203000400400",
    "0000023000400400",
    "0000020300400400",
    "0000020304400000",
    "0000020340400000"
  ]
}
