{
  "puzzle_info": {
    "grid_width": 5,
    "grid_height": 5,
    "steps_to_solve": 18
  },
  "solution_path": [
    "3000000020020000040000000",
    "0000000020020000040030000",
    "0000000020200000040030000",
    "0000000020200000000430000",
    "0000000020200003000400000",
    "0000000020200000003400000",
    "0000400020200000003000000",
    "4000000020200000003000000",
    "0000040020200000003000000",
    "0000040002200000003000000",
    "0000000042200000003000000",
    "0000000040200000003000002",
    "0000000040200000003020000",
    "0000000040200002003000000",
    "0000000040200000023000000",
    "0000000040200300020000000",
    "0000000040230000020000000",
    "2000000040030000020000000",
    "0000200040030000020000000"
  ]
}
