{
  "puzzle_info": {
    "grid_width": 4,
    "grid_height": 4,
    "steps_to_solve": 10
  },
  "solution_path": [
    "0400000000014000",
    "4000000000014000",
    "4000400000010000",
    "0004400000010000",
    "0000400400010000",
    "0000440000010000",
    "4000040000010000",
    "0004040000010000",
    "0000040400010000",
    "0000044000010000",
    "0000040000010040"
  ]
}
