{
  "puzzle_info": {
    "grid_width": 4,
    "grid_height": 4,
    "steps_to_solve": 11
  },
  "solution_path": [
    "2020000000000001",
    "2002000000000001",
    "2000000000020001",
    "0002000000020001",
    "0002000020000001",
    "0000000020020001",
    "0000000022000001",
    "2000000002000001",
    "0002000002000001",
    "0000000002020001",
    "0000000002200001",
    "0000000020200001"
  ]
}
