{
  "puzzle_info": {
    "grid_width": 4,
    "grid_height": 4,
    "steps_to_solve": 14
  },
  "solution_path": [
    "0023000400000000",
    "0003000400000020",
    "3000000400000020",
    "3004000000000020",
    "3024000000000000",
    "3204000000000000",
    "3240000000000000",
    "3040000000000200",
    "0340000000000200",
    "0040000003000200",
    "0040000003002000",
    "2040000003000000",
    "0240000003000000",
    "0040020003000000",
    "0040000203000000"
  ]
}
