{
  "puzzle_info": {
    "grid_width": 4,
    "grid_height": 4,
    "steps_to_solve": 15
  },
  "solution_path": [
    "1000200431000300",
    "1000002431000300",
    "1020000431000300",
    "1002000431000300",
    "1002000401003300",
    "1002000401003003",
    "1002000401033000",
    "1002400001033000",
    "1000400201033000",
    "1000000241033000",
    "1000000241303000",
    "1000000241300003",
    "1000000241330000",
    "1002000041330000",
    "1200000041330000",
    "1000020041330000"
  ]
}
