{
  "puzzle_info": {
    "grid_width": 5,
    "grid_height": 5,
    "steps_to_solve": 15
  },
  "solution_path": [
    "0040000000000300000000020",
    "0040000000000000003000020",
    "0040000000000000003000002",
    "0040200000000000003000000",
    "0004200000000000003000000",
    "0000200000000400003000000",
    "2000000000000400003000000",
    "2000000000000403000000000",
    "0000000000200403000000000",
    "0000000000002403000000000",
    "0004000000002003000000000",
    "3004000000002000000000000",
    "0034000000002000000000000",
    "0004000300002000000000000",
    "4000000300002000000000000",
    "4030000000002000000000000"
  ]
}
