{
  "puzzle_info": {
    "grid_width": 4,
    "grid_height": 4,
    "steps_to_solve": 12
  },
  "solution_path": [
    "4000300000400411",
    "4000000300400411",
    "4000000000430411",
    "4040000000030411",
    "4400000000030411",
    "4400040000030011",
    "4004040000030011",
    "4000040400030011",
    "4000044000030011",
    "4000044030000011",
    "0000444030000011",
    "0000444000003011",
    "0000444000000311"
  ]
}
