{
  "puzzle_info": {
    "grid_width": 4,
    "grid_height": 4,
    "steps_to_solve": 13
  },
  "solution_path": [
    "0303000400001000",
    "3003000400001000",
    "3003400000001000",
    "3003000040001000",
    "3003000000041000",
    "0003000030041000",
    "3000000030041000",
    "3000000000341000",
    "0000000030341000",
    "0000000003341000",
    "0030000003041000",
    "0030000003401000",
    "0000003003401000",
    "0000003003041000"
  ]
}
