{
  "puzzle_info": {
    "grid_width": 4,
    "grid_height": 4,
    "steps_to_solve": 10
  },
  "solution_path": [
    "0001004000000004",
    "0001004000004000",
    "0001000000004040",
    "4001000000000040",
    "0041000000000040",
    "0001000000400040",
    "0001000000404000",
    "4001000000400000",
    "0041000000400000",
    "0001004000400000",
    "0001004000000040"
  ]
}
