{
  "puzzle_info": {
    "grid_width": 5,
    "grid_height": 5,
    "steps_to_solve": 18
  },
  "solution_path": [
    "0000000030001020003000410",
    "0000200030001000003000410",
    "2000000030001000003000410",
    "2000000030001000000300410",
    "2000000030001000000340010",
    "2000040030001000000300010",
    "0000240030001000000300010",
    "0000243000001000000300010",
    "4000203000001000000300010",
    "0004203000001000000300010",
    "0004003000001020000300010",
    "0004003000001200000300010",
    "0000003040001200000300010",
    "0000003040001203000000010",
    "0000003040001003002000010",
    "0000003040001003200000010",
    "3000003040001000200000010",
    "0000303040001000200000010",
    "0000003040001000200000013"
  ]
}
