{
  "puzzle_info": {
    "grid_width": 4,
    "grid_height": 4,
    "steps_to_solve": 10
  },
  "solution_path": [
    "0200200000001000",
    "2000200000001000",
    "2000000020001000",
    "2000000000021000",
    "0000000020021000",
    "0000000000221000",
    "0002000000201000",
    "2000000000201000",
    "0000000020201000",
    "0000000002201000",
    "0000000002021000"
  ]
}
