{
  "puzzle_info": {
    "grid_width": 4,
    "grid_height": 4,
    "steps_to_solve": 14
  },
  "solution_path": [
    "3000000020004300",
    "0000300020004300",
    "0000300000024300",
    "0000300040020300",
    "0000000340020300",
    "0000000342000300",
    "0000000342000003",
    "0000000042030003",
    "0000000042300003",
    "0200000040300003",
    "0200000004300003",
    "0203000004300000",
    "0230000004300000",
    "0200003004300000",
    "0200003004000030"
  ]
}
