{
  "puzzle_info": {
    "grid_width": 4,
    "grid_height": 4,
    "steps_to_solve": 12
  },
  "solution_path": [
    "3020000000020000",
    "3000000000020020",
    "3000000000022000",
    "0000000030022000",
    "0000000000322000",
    "0000000000302002",
    "0000000000302200",
    "2000000000300200",
    "0002000000300200",
    "0202000000300000",
    "0220000000300000",
    "0200002000300000",
    "0200002000030000"
  ]
}
