{
  "puzzle_info": {
    "grid_width": 4,
    "grid_height": 4,
    "steps_to_solve": 10
  },
  "solution_path": [
    "0040040000000200",
    "0040000400000200",
    "0040000000000204",
    "0040000000000240",
    "0040004000000200",
    "0004004000000200",
    "0000004000000204",
    "0000004000000024",
    "0000004000200004",
    "0004004000200000",
    "4000004000200000"
  ]
}
