{
  "puzzle_info": {
    "grid_width": 5,
    "grid_height": 5,
    "steps_to_solve": 17
  },
  "solution_path": [
    "3000000000000020000010000",
    "0000000000000023000010000",
    "0000000000000020000310000",
    "0000000000000020000010003",
    "0000000000000020000013000",
    "0000000000000000000013002",
    "0300000000000000000010002",
    "0300000000000000000012000",
    "0300002000000000000010000",
    "0000302000000000000010000",
    "0000002000000000000010003",
    "0000002000000000000013000",
    "0000002000030000000010000",
    "0000000002030000000010000",
    "0000000000030000000010002",
    "0000000000030000000012000",
    "0000000000030000200010000",
    "0000000000300000200010000"
  ]
}
