{
  "puzzle_info": {
    "grid_width": 4,
    "grid_height": 4,
    "steps_to_solve": 12
  },
  "solution_path": [
    "0030000200001003",
    "0030200000001003",
    "2030000000001003",
    "0230000000001003",
    "0200000000001033",
    "0200000000001303",
    "0200030000001003",
    "0200030000001300",
    "0200030003001000",
    "0200000303001000",
    "0000020303001000",
    "0000023003001000",
    "0000203003001000"
  ]
}
