{
  "puzzle_info": {
    "grid_width": 4,
    "grid_height": 4,
    "steps_to_solve": 11
  },
  "solution_path": [
    "0002000002300000",
    "2000000002300000",
    "2000000002030000",
    "2000000000230000",
    "2003000000200000",
    "0023000000200000",
    "0003002000200000",
    "0000002000200003",
    "0000002000203000",
    "0000002000003020",
    "0000002000000320",
    "0300002000000020"
  ]
}
