{
  "puzzle_info": {
    "grid_width": 5,
    "grid_height": 5,
    "steps_to_solve": 18
  },
  "solution_path": [
    "0000000000202000220000100",
    "0200000000202000020000100",
    "0200000000022000020000100",
    "0000002000022000020000100",
    "0000002000020020020000100",
    "0000002000000220020000100",
    "0000202000000200020000100",
    "0020202000000200000000100",
    "0002202000000200000000100",
    "0000202020000200000000100",
    "0000002020000200000000102",
    "0000002020000200000000120",
    "0000002020000200002000100",
    "0000002020200000002000100",
    "0000002020000000002020100",
    "0000002020000000002002100",
    "0000002020020000002000100",
    "0000000220020000002000100",
    "0000000202020000002000100"
  ]
}
