{
  "puzzle_info": {
    "grid_width": 4,
    "grid_height": 4,
    "steps_to_solve": 13
  },
  "solution_path": [
    "0000200003000020",
    "0000000003002020",
    "0000000000032020",
    "0000000000002023",
    "0000000000000223",
    "0020000000000203",
    "0020000000000230",
    "0000000000200230",
    "0200000000200030",
    "0200000000200003",
    "0203000000200000",
    "0230000000200000",
    "0200003000200000",
    "0200300000200000"
  ]
}
