{
  "puzzle_info": {
    "grid_width": 4,
    "grid_height": 4,
    "steps_to_solve": 12
  },
  "solution_path": [
    "0030000304001013",
    "0030000004031013",
    "0030000040031013",
    "0030000043001013",
    "4030000003001013",
    "4300000003001013",
    "4000030003001013",
    "4000030000001313",
    "4003030000001310",
    "4300030000001310",
    "0300030040001310",
    "0300030000041310",
    "0300030000001314"
  ]
}
