{
  "puzzle_info": {
    "grid_width": 4,
    "grid_height": 4,
    "steps_to_solve": 14
  },
  "solution_path": [
    "4303000000000020",
    "0303000000004020",
    "0033000000004020",
    "0030000000004023",
    "0030002000004003",
    "0030002000000043",
    "0030000000200043",
    "0000003000200043",
    "0000003020000043",
    "0000003020400003",
    "0003003020400000",
    "3000003020400000",
    "0000303020400000",
    "0000303002400000",
    "0000303002000040"
  ]
}
