{
  "puzzle_info": {
    "grid_width": 4,
    "grid_height": 4,
    "steps_to_solve": 12
  },
  "solution_path": [
    "0040030003000003",
    "0000030003000043",
    "0000000303000043",
    "0000000303004003",
    "0000000300004303",
    "0000000300004330",
    "0300000300004030",
    "0300000300000430",
    "0300040300000030",
    "3000040300000030",
    "3000043000000030",
    "3000043000300000",
    "3030040000300000"
  ]
}
