{
  "puzzle_info": {
    "grid_width": 4,
    "grid_height": 4,
    "steps_to_solve": 11
  },
  "solution_path": [
    "0000142220000000",
    "0000140220000020",
    "0000104220000020",
    "0040100220000020",
    "0040100220000002",
    "0040100020020002",
    "0040100000220002",
    "0040100000222000",
    "0040100020220000",
    "0040100002220000",
    "0040100002020020",
    "0040100002200020"
  ]
}
