{
  "puzzle_info": {
    "grid_width": 4,
    "grid_height": 4,
    "steps_to_solve": 13
  },
  "solution_path": [
    "0040230040000000",
    "0040200040000300",
    "0040200000040300",
    "0040200000043000",
    "0040200030040000",
    "0040200000340000",
    "0040200000300004",
    "0040200000304000",
    "0040000020304000",
    "0040000002304000",
    "4040000002300000",
    "0440000002300000",
    "0400004002300000",
    "0400004002030000"
  ]
}
