{
  "puzzle_info": {
    "grid_width": 4,
    "grid_height": 4,
    "steps_to_solve": 14
  },
  "solution_path": [
    "0000330040000020",
    "3000030040000020",
    "3000000040000320",
    "3020000040000300",
    "0320000040000300",
    "0020000043000300",
    "4020000003000300",
    "4200000003000300",
    "4000020003000300",
    "0004020003000300",
    "0004020000030300",
    "0000020400030300",
    "0000020403030000",
    "0000020403300000",
    "0000020430300000"
  ]
}
