{
  "puzzle_info": {
    "grid_width": 5,
    "grid_height": 5,
    "steps_to_solve": 16
  },
  "solution_path": [
    "0000030000003400003000000",
    "0000000003003400003000000",
    "0004000003003000003000000",
    "4000000003003000003000000",
    "4003000003003000000000000",
    "0043000003003000000000000",
    "0040000003003000000000030",
    "0040000003003000000000003",
    "0040000003003030000000000",
    "0040030000003030000000000",
    "0000030400003030000000000",
    "0000003400003030000000000",
    "0000003400003300000000000",
    "0000003400000300000000300",
    "0000003000000300040000300",
    "0000003000000300040030000",
    "3000003000000300040000000"
  ]
}
