{
  "puzzle_info": {
    "grid_width": 4,
    "grid_height": 4,
    "steps_to_solve": 10
  },
  "solution_path": [
    "0000040000044004",
    "0004040000004004",
    "0004040000000044",
    "0004040400000040",
    "4000040400000040",
    "0000040400004040",
    "0000044000004040",
    "0000044000000440",
    "0000004004000440",
    "0000004004004040",
    "4000004004000040"
  ]
}
