{
  "puzzle_info": {
    "grid_width": 4,
    "grid_height": 4,
    "steps_to_solve": 14
  },
  "solution_path": [
    "0344000002000000",
    "0044030002000000",
    "4004030002000000",
    "4000030002000004",
    "4000000302000004",
    "4000000002030004",
    "4000000000230004",
    "4000000000234000",
    "0000000040234000",
    "0000000004234000",
    "0020000004034000",
    "0020000004304000",
    "4020000004300000",
    "0420000004300000",
    "0400002004300000"
  ]
}
