{
  "puzzle_info": {
    "grid_width": 4,
    "grid_height": 4,
    "steps_to_solve": 11
  },
  "solution_path": [
    "2001004010000202",
    "0001204010000202",
    "0001240010000202",
    "0001200014000202",
    "0001000214000202",
    "0001000214020200",
    "0001000214200200",
    "0001000214200002",
    "0001000214220000",
    "0001200014220000",
    "2001000014220000",
    "0021000014220000"
  ]
}
