{
  "puzzle_info": {
    "grid_width": 4,
    "grid_height": 4,
    "steps_to_solve": 12
  },
  "solution_path": [
    "0040000442000000",
    "0000000442000040",
    "0000000442000004",
    "0000000042040004",
    "0000000040240004",
    "0000000004240004",
    "0020000004040004",
    "0020000004400004",
    "0020000004404000",
    "4020000004400000",
    "0420000004400000",
    "0400002004400000",
    "0400002004040000"
  ]
}
