{
  "puzzle_info": {
    "grid_width": 4,
    "grid_height": 4,
    "steps_to_solve": 13
  },
  "solution_path": [
    "4400300000000000",
    "4000300000000400",
    "4000000300000400",
    "4003000000000400",
    "4300000000000400",
    "4300040000000000",
    "4003040000000000",
    "0043040000000000",
    "0003040000000040",
    "3000040000000040",
    "0000040000003040",
    "0000040000000340",
    "0000040003000040",
    "0000040000030040"
  ]
}
