{
  "puzzle_info": {
    "grid_width": 4,
    "grid_height": 4,
    "steps_to_solve": 13
  },
  "solution_path": [
    "0000000000304002",
    "0002000000304000",
    "2000000000304000",
    "0000000020304000",
    "0000000002304000",
    "0030000002004000",
    "4030000002000000",
    "4300000002000000",
    "0300000002004000",
    "0300000002000004",
    "0304000002000000",
    "0340000002000000",
    "0040030002000000",
    "0040030000020000"
  ]
}
