{
  "puzzle_info": {
    "grid_width": 4,
    "grid_height": 4,
    "steps_to_solve": 16
  },
  "solution_path": [
    "3410010000000002",
    "0410010000003002",
    "4010010000003002",
    "0010010040003002",
    "0010010000043002",
    "0010010000043200",
    "0010010000003204",
    "0010010002003004",
    "0010010002003400",
    "3010010002000400",
    "3010010020000400",
    "0010310020000400",
    "0010310000020400",
    "0010310004020000",
    "0010310004200000",
    "0010312004000000",
    "0010310204000000"
  ]
}
