{
  "puzzle_info": {
    "grid_width": 4,
    "grid_height": 4,
    "steps_to_solve": 10
  },
  "solution_path": [
    "0003103301000000",
    "0003103001000003",
    "0000103001030003",
    "0000103001300003",
    "0000103001303000",
    "0000103001003030",
    "0000103001000330",
    "0000103001300300",
    "0000130001300300",
    "0300100001300300",
    "0300100001030300"
  ]
}
