{
  "puzzle_info": {
    "grid_width": 4,
    "grid_height": 4,
    "steps_to_solve": 11
  },
  "solution_path": [
    "0000000000201400",
    "0000000000201004",
    "0000000000001024",
    "0000000000001204",
    "0200000000001004",
    "0200000000001400",
    "0200040000001000",
    "0002040000001000",
    "0000040000001002",
    "0000040000001200",
    "0000040002001000",
    "0000000402001000"
  ]
}
