{
  "puzzle_info": {
    "grid_width": 4,
    "grid_height": 4,
    "steps_to_solve": 12
  },
  "solution_path": [
    "3000000000204000",
    "3000000000200004",
    "3004000000200000",
    "0034000000200000",
    "0004003000200000",
    "4000003000200000",
    "4000003020000000",
    "4000203000000000",
    "4000023000000000",
    "0000023000004000",
    "0000020000004030",
    "0000020000000430",
    "0030020000000400"
  ]
}
