{
  "puzzle_info": {
    "grid_width": 5,
    "grid_height": 5,
    "steps_to_solve": 9
  },
  "solution_path": [
    "3000000000000000000000020",
    "0000300000000000000000020",
    "0000000000000000000000023",
    "0000000000000000000020003",
    "0000000000000000000023000",
    "2000000000000000000003000",
    "0000200000000000000003000",
    "0300200000000000000000000",
    "0320000000000000000000000",
    "3020000000000000000000000"
  ]
}
