{
  "puzzle_info": {
    "grid_width": 4,
    "grid_height": 4,
    "steps_to_solve": 10
  },
  "solution_path": [
    "0030000000100200",
    "3000000000100200",
    "3000000000102000",
    "0000000030102000",
    "0000000003102000",
    "2000000003100000",
    "2000000030100000",
    "0000200030100000",
    "0000000230100000",
    "0000000203100000",
    "0000000200100300"
  ]
}
