{
  "puzzle_info": {
    "grid_width": 4,
    "grid_height": 4,
    "steps_to_solve": 13
  },
  "solution_path": [
    "0441001040030000",
    "0441001043000000",
    "0441031040000000",
    "4041031040000000",
    "4041031000040000",
    "0041031000044000",
    "4001031000044000",
    "0001031040044000",
    "0001301040044000",
    "0001301000444000",
    "0001301040440000",
    "0001301004440000",
    "0001301004040040",
    "0001301004400040"
  ]
}
