{
  "puzzle_info": {
    "grid_width": 4,
    "grid_height": 4,
    "steps_to_solve": 12
  },
  "solution_path": [
    "0402000040000000",
    "0042000040000000",
    "0040000040000002",
    "4040000000000002",
    "0440000000000002",
    "0440000000002000",
    "0400000000002040",
    "0400000000000240",
    "0400020000000040",
    "4000020000000040",
    "0000020000004040",
    "0000020000000440",
    "0040020000000400"
  ]
}
