{
  "puzzle_info": {
    "grid_width": 4,
    "grid_height": 4,
    "steps_to_solve": 13
  },
  "solution_path": [
    "0040200000030000",
    "4000200000030000",
    "4000000200030000",
    "4000000230000000",
    "0000400230000000",
    "0000420030000000",
    "0000420000003000",
    "0000020040003000",
    "0000020000043000",
    "3000020000040000",
    "0003020000040000",
    "0000020300040000",
    "0000023000040000",
    "0030020000040000"
  ]
}
