{
  "puzzle_info": {
    "grid_width": 5,
    "grid_height": 5,
    "steps_to_solve": 17
  },
  "solution_path": [
    "0040000000000000004200040",
    "0000400000000000004200040",
    "0000000000000040004200040",
    "0000000000400000004200040",
    "0000000000400000004240000",
    "0000000000400004004200000",
    "0000000000000044004200000",
    "0000000000000044400200000",
    "0000000000000044420000000",
    "0400000000000044020000000",
    "0400000000000040420000000",
    "0400004000000040020000000",
    "0000404000000040020000000",
    "0000004004000040020000000",
    "0000004400000040020000000",
    "0000004000004040020000000",
    "0000004000004400020000000",
    "0000004000400400020000000"
  ]
}
