{
  "puzzle_info": {
    "grid_width": 4,
    "grid_height": 4,
    "steps_to_solve": 10
  },
  "solution_path": [
    "0000000000020210",
    "0000000020000210",
    "0000000000002210",
    "0200000000002010",
    "0200000000000210",
    "0200020000000010",
    "2000020000000010",
    "0000020000002010",
    "0000020000000210",
    "0000020002000010",
    "0000020000020010"
  ]
}
