{
  "puzzle_info": {
    "grid_width": 4,
    "grid_height": 4,
    "steps_to_solve": 11
  },
  "solution_path": [
    "0030400010300000",
    "0003400010300000",
    "4003000010300000",
    "0043000010300000",
    "0043000010000030",
    "0003000010400030",
    "0003000010400003",
    "0003000310400000",
    "3000000310400000",
    "0000300310400000",
    "0000330010400000",
    "3000030010400000"
  ]
}
