{
  "puzzle_info": {
    "grid_width": 4,
    "grid_height": 4,
    "steps_to_solve": 17
  },
  "solution_path": [
    "0100310004003020",
    "0100010034003020",
    "0100010030003420",
    "0100010000033420",
    "0100010004033020",
    "0100010040033020",
    "4100010000033020",
    "4100010000033200",
    "4100010002033000",
    "4100010020033000",
    "0100410020033000",
    "0100410000233000",
    "0103410000203000",
    "0103410000200003",
    "0103410300200000",
    "0130410300200000",
    "0100413300200000",
    "0100413300000020"
  ]
}
