{
  "puzzle_info": {
    "grid_width": 4,
    "grid_height": 4,
    "steps_to_solve": 13
  },
  "solution_path": [
    "3002000000000040",
    "0032000000000040",
    "0030000000000042",
    "0030000000004002",
    "0030000000004200",
    "4030000000000200",
    "0430000000000200",
    "0030000004000200",
    "0030000004002000",
    "2030000004000000",
    "0230000004000000",
    "0030020004000000",
    "0000020004000030",
    "0000020000040030"
  ]
}
