{
  "puzzle_info": {
    "grid_width": 4,
    "grid_height": 4,
    "steps_to_solve": 14
  },
  "solution_path": [
    "0000300002004000",
    "3000000002004000",
    "3000400002000000",
    "3000000402000000",
    "3000000420000000",
    "0000300420000000",
    "0000340020000000",
    "0000340000002000",
    "0000040030002000",
    "0000040000032000",
    "2000040000030000",
    "0002040000030000",
    "0000040200030000",
    "0000042000030000",
    "0000002000030400"
  ]
}
