{
  "puzzle_info": {
    "grid_width": 4,
    "grid_height": 4,
    "steps_to_solve": 10
  },
  "solution_path": [
    "3030000000031100",
    "0030000030031100",
    "0030000000331100",
    "0030003000031100",
    "3000003000031100",
    "3000003030001100",
    "0000303030001100",
    "0000033030001100",
    "0000033000031100",
    "0000033000001103",
    "0000033000001130"
  ]
}
