{
  "puzzle_info": {
    "grid_width": 4,
    "grid_height": 4,
    "steps_to_solve": 13
  },
  "solution_path": [
    "0023000000000400",
    "0003000000000420",
    "0403000000000020",
    "0043000000000020",
    "0003000000400020",
    "0003000000400002",
    "0003000200400000",
    "3000000200400000",
    "0000000200403000",
    "0000200000403000",
    "0000200030400000",
    "0000000230400000",
    "0000000203400000",
    "0000000203000040"
  ]
}
