{
  "puzzle_info": {
    "grid_width": 5,
    "grid_height": 5,
    "steps_to_solve": 16
  },
  "solution_path": [
    "0401000000000000003001400",
    "0041000000000000003001400",
    "0041000000000003000001400",
    "0001000000000003040001400",
    "3001000000000000040001400",
    "0031000000000000040001400",
    "0031000400000000000001400",
    "0031000400004000000001000",
    "0031040000004000000001000",
    "0001040300004000000001000",
    "0001004300004000000001000",
    "0001004003004000000001000",
    "0001004000004000000001003",
    "0001004000004000000001300",
    "0001004000004000030001000",
    "0001004000400000030001000",
    "0001004000000000030041000"
  ]
}
