{
  "puzzle_info": {
    "grid_width": 5,
    "grid_height": 5,
    "steps_to_solve": 18
  },
  "solution_path": [
    "0000010000000000000300402",
    "0000010000000003000000402",
    "0000010000300000000000402",
    "0000010000000030000000402",
    "0000010000000030000000042",
    "0004010000000030000000002",
    "0004010000000030000020000",
    "0004010000200030000000000",
    "0004010000000230000000000",
    "0000010040000230000000000",
    "0000010040000030000000020",
    "0000010040300000000000020",
    "0000010040300200000000000",
    "0000010040003200000000000",
    "0000010040003000000000020",
    "0000010040003000000020000",
    "0000010040203000000000000",
    "0000010040023000000000000",
    "0000010040020000000000300"
  ]
}
