{
  "puzzle_info": {
    "grid_width": 4,
    "grid_height": 4,
    "steps_to_solve": 13
  },
  "solution_path": [
    "0000300010003410",
    "3000000010003410",
    "3400000010003010",
    "3400000010000310",
    "3400030010000010",
    "3400000310000010",
    "3403000010000010",
    "3430000010000010",
    "3030000010000410",
    "0330000010000410",
    "0300000010300410",
    "0300000013000410",
    "0300000013004010",
    "0300000010004310"
  ]
}
