{
  "puzzle_info": {
    "grid_width": 4,
    "grid_height": 4,
    "steps_to_solve": 12
  },
  "solution_path": [
    "0002004000000044",
    "0042000000000044",
    "0042000400000040",
    "0042400000000040",
    "4042000000000040",
    "0442000000000040",
    "0402000000400040",
    "0420000000400040",
    "0400002000400040",
    "0400002040000040",
    "0400002040400000",
    "0400002004400000",
    "0400002004000040"
  ]
}
