{
  "puzzle_info": {
    "grid_width": 4,
    "grid_height": 4,
    "steps_to_solve": 18
  },
  "solution_path": [
    "2014001300000040",
    "0014001300002040",
    "0014001000002043",
    "0010001000042043",
    "0010001040002043",
    "0010001040002403",
    "0010001040002430",
    "0410001040002030",
    "4010001040002030",
    "4010001040302000",
    "4010001040300002",
    "4012001040300000",
    "4012001040030000",
    "4010001240030000",
    "4010001243000000",
    "4010401203000000",
    "0410401203000000",
    "0010441203000000",
    "0010441200000300"
  ]
}
