{
  "puzzle_info": {
    "grid_width": 4,
    "grid_height": 4,
    "steps_to_solve": 14
  },
  "solution_path": [
    "0004000304000200",
    "4000000304000200",
    "4000000004000203",
    "4000000004002003",
    "4000200004000003",
    "0004200004000003",
    "0000200004040003",
    "0000200000440003",
    "0000200000443000",
    "0000200030440000",
    "0000200003440000",
    "0040200003040000",
    "0040200003400000",
    "0000204003400000",
    "0000204003000040"
  ]
}
