{
  "puzzle_info": {
    "grid_width": 4,
    "grid_height": 4,
    "steps_to_solve": 12
  },
  "solution_path": [
    "0000400200400003",
    "0000400200403000",
    "0000000240403000",
    "0000000244003000",
    "4000000204003000",
    "4000300204000000",
    "4000003204000000",
    "4030000204000000",
    "0430000204000000",
    "0030040204000000",
    "0000040204000030",
    "0000042004000030",
    "0400002004000030"
  ]
}
