{
  "puzzle_info": {
    "grid_width": 4,
    "grid_height": 4,
    "steps_to_solve": 13
  },
  "solution_path": [
    "0004020300000400",
    "0004200300000400",
    "0004230000000400",
    "0004200003000400",
    "0004200003000004",
    "0004200403000000",
    "4000200403000000",
    "4000002403000000",
    "4020000403000000",
    "0420000403000000",
    "0020040403000000",
    "0000040403000020",
    "0000044003000020",
    "0000404003000020"
  ]
}
