{
  "puzzle_info": {
    "grid_width": 4,
    "grid_height": 4,
    "steps_to_solve": 10
  },
  "solution_path": [
    "0000003400010000",
    "0030000400010000",
    "0003000400010000",
    "0003400000010000",
    "0000400300010000",
    "0000430000010000",
    "4000030000010000",
    "0004030000010000",
    "0000030400010000",
    "0000034000010000",
    "0000030000010040"
  ]
}
