{
  "puzzle_info": {
    "grid_width": 4,
    "grid_height": 4,
    "steps_to_solve": 11
  },
  "solution_path": [
    "4000410040041000",
    "4000410000441000",
    "4000010040441000",
    "4040010040041000",
    "0440010040041000",
    "0440010000441000",
    "0440014000041000",
    "0404014000041000",
    "0400014400041000",
    "0400014400001004",
    "0400014400001400",
    "0400014404001000"
  ]
}
