{
  "puzzle_info": {
    "grid_width": 4,
    "grid_height": 4,
    "steps_to_solve": 12
  },
  "solution_path": [
    "0004400020000400",
    "0004400000020400",
    "0000400400020400",
    "0000400400000402",
    "0000400400004002",
    "0000400400004200",
    "0000400440000200",
    "0000004440000200",
    "0000004040000204",
    "0000004040000240",
    "0200004040000040",
    "0200004040400000",
    "0200004004400000"
  ]
}
