{
  "puzzle_info": {
    "grid_width": 4,
    "grid_height": 4,
    "steps_to_solve": 14
  },
  "solution_path": [
    "0032000400000000",
    "0002000400000030",
    "2000000400000030",
    "2004000000000030",
    "2034000000000000",
    "2304000000000000",
    "2340000000000000",
    "2040000000000300",
    "0240000000000300",
    "0040000002000300",
    "0040000002003000",
    "3040000002000000",
    "0340000002000000",
    "0040030002000000",
    "0040000302000000"
  ]
}
