{
  "puzzle_info": {
    "grid_width": 5,
    "grid_height": 5,
    "steps_to_solve": 16
  },
  "solution_path": [
    "3000000000000000012000400",
    "3000000000000000010000420",
    "3000000000000000010040020",
    "3000040000000000010000020",
    "3000040000000000010020000",
    "3000040000200000010000000",
    "3000000004200000010000000",
    "0000030004200000010000000",
    "0000000034200000010000000",
    "0000400030200000010000000",
    "4000000030200000010000000",
    "0000040030200000010000000",
    "0000000430200000010000000",
    "0000000030204000010000000",
    "0000000030240000010000000",
    "2000000030040000010000000",
    "0000200030040000010000000"
  ]
}
