{
  "puzzle_info": {
    "grid_width": 4,
    "grid_height": 4,
    "steps_to_solve": 14
  },
  "solution_path": [
    "0320300000400000",
    "0020300000400300",
    "0020304000000300",
    "0002304000000300",
    "0002340000000300",
    "0002040000003300",
    "0002040000003003",
    "0002040000000033",
    "0002040300000030",
    "2000040300000030",
    "0000040300002030",
    "0000043000002030",
    "0000043000000230",
    "0000043000300200",
    "0030040000300200"
  ]
}
