{
  "puzzle_info": {
    "grid_width": 4,
    "grid_height": 4,
    "steps_to_solve": 13
  },
  "solution_path": [
    "0000003000320004",
    "0000000300320004",
    "0000000330020004",
    "0000000332000004",
    "0000000332040000",
    "0003000032040000",
    "3000000032040000",
    "3000000030240000",
    "3000000003240000",
    "3020000003040000",
    "0320000003040000",
    "0320000003400000",
    "0300002003400000",
    "0300002003000040"
  ]
}
