{
  "puzzle_info": {
    "grid_width": 5,
    "grid_height": 5,
    "steps_to_solve": 17
  },
  "solution_path": [
    "0010000000003400100000300",
    "0010000000300400100000300",
    "0010000000340000100000300",
    "3010000000040000100000300",
    "0310000000040000100000300",
    "0310004000000000100000300",
    "3010004000000000100000300",
    "0010004000000000100030300",
    "0010004000000000100030003",
    "0010004000000000100000033",
    "0010304000000000100000030",
    "0013004000000000100000030",
    "0010004000000000103000030",
    "0010004000000000103000003",
    "0010304000000000103000000",
    "0013004000000000103000000",
    "0010004000000300103000000",
    "0010004000000300100000030"
  ]
}
