{
  "puzzle_info": {
    "grid_width": 4,
    "grid_height": 4,
    "steps_to_solve": 13
  },
  "solution_path": [
    "0020400000004000",
    "2000400000004000",
    "2000000400004000",
    "2000000000004004",
    "2000000000000044",
    "2004000000000040",
    "2400000000000040",
    "0400000000002040",
    "0400000000000240",
    "0400020000000040",
    "4000020000000040",
    "0000020000004040",
    "0000020000000440",
    "0040020000000400"
  ]
}
