{
  "puzzle_info": {
    "grid_width": 5,
    "grid_height": 5,
    "steps_to_solve": 19
  },
  "solution_path": [
    "0000200000300000020010010",
    "2000000000300000020010010",
    "2000000000000030020010010",
    "2020000000000030000010010",
    "0220000000000030000010010",
    "0200000000000030000010210",
    "0200000000000030000012010",
    "0200002000000030000010010",
    "0000202000000030000010010",
    "0000002002000030000010010",
    "0000002200000030000010010",
    "0000000200000030000012010",
    "0000000200000030000010210",
    "0000000200002030000010010",
    "0000000200002300000010010",
    "0000000200200300000010010",
    "0000000000200300000010210",
    "0000000000002300000010210",
    "0000000000002300000012010",
    "0200000000002300000010010"
  ]
}
