{
  "puzzle_info": {
    "grid_width": 4,
    "grid_height": 4,
    "steps_to_solve": 12
  },
  "solution_path": [
    "2004000000200040",
    "0004000000202040",
    "0004000000202400",
    "2004000000200400",
    "2400000000200400",
    "2000000004200400",
    "2020000004000400",
    "0220000004000400",
    "0020020004000400",
    "0002020004000400",
    "0002020000040400",
    "0002020004040000",
    "0002020004400000"
  ]
}
