{
  "puzzle_info": {
    "grid_width": 4,
    "grid_height": 4,
    "steps_to_solve": 11
  },
  "solution_path": [
    "0000004001022000",
    "0000004001002002",
    "0000004001000022",
    "0000000001400022",
    "0002000001400020",
    "0002000001040020",
    "0000000201040020",
    "0000200001040020",
    "0020200001040000",
    "0020200001400000",
    "0000202001400000",
    "0000202001040000"
  ]
}
