{
  "puzzle_info": {
    "grid_width": 4,
    "grid_height": 4,
    "steps_to_solve": 12
  },
  "solution_path": [
    "0000000100042040",
    "0000000140002040",
    "0000000140000240",
    "0200000140000040",
    "0200000140000004",
    "0200000140040000",
    "0200000144000000",
    "0000020144000000",
    "0000020104004000",
    "0000020104000004",
    "0000020104040000",
    "0000020104400000",
    "0000020100400400"
  ]
}
