{
  "puzzle_info": {
    "grid_width": 4,
    "grid_height": 4,
    "steps_to_solve": 12
  },
  "solution_path": [
    "0000000042404000",
    "4000000002404000",
    "4000000002004040",
    "4000000002000440",
    "4040000002000400",
    "0440000002000400",
    "0040040002000400",
    "0004040002000400",
    "0004040000020400",
    "0000040400020400",
    "0000040404020000",
    "0000040404200000",
    "0000040400200400"
  ]
}
