{
  "puzzle_info": {
    "grid_width": 4,
    "grid_height": 4,
    "steps_to_solve": 13
  },
  "solution_path": [
    "0200000400420000",
    "0000000400420200",
    "0000400000420200",
    "0000400000422000",
    "0000000040422000",
    "0000000044022000",
    "0000000044202000",
    "0400000040202000",
    "0400000004202000",
    "0400000004200002",
    "0402000004200000",
    "0420000004200000",
    "0020040004200000",
    "0020040000200400"
  ]
}
