{
  "puzzle_info": {
    "grid_width": 4,
    "grid_height": 4,
    "steps_to_solve": 12
  },
  "solution_path": [
    "0003004040000000",
    "3000004040000000",
    "0000304040000000",
    "0000034040000000",
    "0000030040000040",
    "0000030000004040",
    "0000030000000440",
    "0000030004000040",
    "0000000304000040",
    "0000000304000004",
    "0000000304040000",
    "0000000304400000",
    "0400000300400000"
  ]
}
