{
  "puzzle_info": {
    "grid_width": 4,
    "grid_height": 4,
    "steps_to_solve": 10
  },
  "solution_path": [
    "0000010000023000",
    "0000010020003000",
    "0000010020000003",
    "0000010000002003",
    "0000010000000023",
    "0020010000000003",
    "0020010000003000",
    "0000010000003020",
    "0000010000000320",
    "0000010003000020",
    "0020010003000000"
  ]
}
