{
  "puzzle_info": {
    "grid_width": 4,
    "grid_height": 4,
    "steps_to_solve": 12
  },
  "solution_path": [
    "2002000000303000",
    "2002300000300000",
    "0022300000300000",
    "0020300000300002",
    "0020303000000002",
    "0020033000000002",
    "0020030300000002",
    "0000030300000022",
    "0000030300020020",
    "0000033000020020",
    "0000033020000020",
    "0000033020200000",
    "0000030320200000"
  ]
}
