{
  "puzzle_info": {
    "grid_width": 4,
    "grid_height": 4,
    "steps_to_solve": 10
  },
  "solution_path": [
    "4040000040200000",
    "4040000040020000",
    "4040000000420000",
    "4040000000400002",
    "4040000000402000",
    "0040000040402000",
    "0040000004402000",
    "2040000004400000",
    "0240000004400000",
    "0040020004400000",
    "0040020000400400"
  ]
}
