{
  "puzzle_info": {
    "grid_width": 4,
    "grid_height": 4,
    "steps_to_solve": 10
  },
  "solution_path": [
    "3003003000000000",
    "0033003000000000",
    "0033000000000030",
    "0003000000300030",
    "3000000000300030",
    "3000000000303000",
    "0000000030303000",
    "0000000003303000",
    "0000000003033000",
    "3000000003030000",
    "0003000003030000"
  ]
}
