{
  "puzzle_info": {
    "grid_width": 4,
    "grid_height": 4,
    "steps_to_solve": 12
  },
  "solution_path": [
    "0000023000000004",
    "0000003000000204",
    "0000003000000024",
    "0000003000200004",
    "0030000000200004",
    "0003000000200004",
    "0003000400200000",
    "3000000400200000",
    "0000000400203000",
    "0000400000203000",
    "0000400030200000",
    "0000400003200000",
    "0020400003000000"
  ]
}
