{
  "puzzle_info": {
    "grid_width": 4,
    "grid_height": 4,
    "steps_to_solve": 11
  },
  "solution_path": [
    "0220000000200003",
    "0020000000200203",
    "0002000000200203",
    "0002000000202003",
    "0002000300202000",
    "0002300000202000",
    "0002300020200000",
    "0002300002200000",
    "0002300002020000",
    "0000300202020000",
    "0000003202020000",
    "0000003202000002"
  ]
}
