{
  "puzzle_info": {
    "grid_width": 4,
    "grid_height": 4,
    "steps_to_solve": 12
  },
  "solution_path": [
    "2000000300000003",
    "2000000300030000",
    "2000000330000000",
    "0000200330000000",
    "0000002330000000",
    "0003002030000000",
    "3000002030000000",
    "0000302030000000",
    "0000032030000000",
    "0000030030000020",
    "0000030000003020",
    "0000030000000320",
    "0020030000000300"
  ]
}
