{
  "puzzle_info": {
    "grid_width": 4,
    "grid_height": 4,
    "steps_to_solve": 13
  },
  "solution_path": [
    "0200000002000430",
    "2000000002000430",
    "2000000000020430",
    "2030000000020400",
    "2300000000020400",
    "0300000000022400",
    "0300040000022000",
    "0300400000022000",
    "0300400020020000",
    "0300400000220000",
    "0302400000200000",
    "0320400000200000",
    "0020400000200300",
    "0000402000200300"
  ]
}
