{
  "puzzle_info": {
    "grid_width": 5,
    "grid_height": 5,
    "steps_to_solve": 16
  },
  "solution_path": [
    "0030000000300000300000020",
    "3030000000000000300000020",
    "0330000000000000300000020",
    "0330003000000000000000020",
    "0330003000000000000020000",
    "0300003000000000000020300",
    "0300003000000000000002300",
    "0300003000020000000000300",
    "0300000003020000000000300",
    "0000003003020000000000300",
    "0000000033020000000000300",
    "0000000030020000000000303",
    "0000000030020000000000330",
    "0000000030020300000000300",
    "0000000030023000000000300",
    "0000000030023000030000000",
    "0000000030020030030000000"
  ]
}
