{
  "puzzle_info": {
    "grid_width": 4,
    "grid_height": 4,
    "steps_to_solve": 12
  },
  "solution_path": [
    "0002000404000000",
    "0002000004000004",
    "0000000004020004",
    "0000000004200004",
    "0400000000200004",
    "0404000000200000",
    "0044000000200000",
    "0004004000200000",
    "4000004000200000",
    "4000004020000000",
    "0000404020000000",
    "0000044020000000",
    "0000040020000040"
  ]
}
