{
  "puzzle_info": {
    "grid_width": 5,
    "grid_height": 5,
    "steps_to_solve": 18
  },
  "solution_path": [
    "0040000020000000000020004",
    "0000000020000000000020404",
    "0002000000000000000020404",
    "2002000000000000000000404",
    "0022000000000000000000404",
    "0002000000000000020000404",
    "0002000000000000020000044",
    "0002000040000000020000004",
    "2000000040000000020000004",
    "2000000040000000020040000",
    "2000040040000000020000000",
    "2000000440000000020000000",
    "2000000040004000020000000",
    "2000000040400000020000000",
    "0000020040400000020000000",
    "0000000240400000020000000",
    "0000000040402000020000000",
    "0000000040042000020000000",
    "0000000040040020020000000"
  ]
}
