{
  "puzzle_info": {
    "grid_width": 4,
    "grid_height": 4,
    "steps_to_solve": 12
  },
  "solution_path": [
    "0100200000040000",
    "0104200000000000",
    "0140200000000000",
    "0100200000000040",
    "0100000200000040",
    "0102000000000040",
    "0120000000000040",
    "0100000000200040",
    "0100000000200004",
    "0104000000200000",
    "0140000000200000",
    "0100004000200000",
    "0100004000020000"
  ]
}
