{
  "puzzle_info": {
    "grid_width": 4,
    "grid_height": 4,
    "steps_to_solve": 13
  },
  "solution_path": [
    "0100001002002004",
    "0100001000002204",
    "0100001000002240",
    "0100001000402200",
    "0100001000402002",
    "0100001000400022",
    "0102001000400020",
    "0102001000040020",
    "0100001200040020",
    "0100001240000020",
    "0100001240200000",
    "0100001204200000",
    "0100041200200000",
    "0100401200200000"
  ]
}
