{
  "puzzle_info": {
    "grid_width": 5,
    "grid_height": 5,
    "steps_to_solve": 19
  },
  "solution_path": [
    "0100040000000002000040030",
    "0100040000200000000040030",
    "0100000004200000000040030",
    "0100000004200000000040003",
    "0100000004200030000040000",
    "0100000004230000000040000",
    "0100000004030002000040000",
    "0100000004030002000000004",
    "0100000004030042000000000",
    "0100000004034002000000000",
    "0100000004034000000200000",
    "0100000000034040000200000",
    "0100000000034400000200000",
    "0100000000030400000200400",
    "0100000000030402000000400",
    "0100000000030400000020400",
    "0100000000030400000002400",
    "0100000000030400200000400",
    "0100003000000400200000400",
    "0140003000000400200000000"
  ]
}
