{
  "puzzle_info": {
    "grid_width": 4,
    "grid_height": 4,
    "steps_to_solve": 13
  },
  "solution_path": [
    "2000000003004000",
    "2000400003000000",
    "2000000403000000",
    "2000000430000000",
    "0000200430000000",
    "0000240030000000",
    "0000240000003000",
    "0000040020003000",
    "0000040000023000",
    "3000040000020000",
    "0003040000020000",
    "0000040300020000",
    "0000043000020000",
    "0000040000020030"
  ]
}
