{
  "puzzle_info": {
    "grid_width": 5,
    "grid_height": 5,
    "steps_to_solve": 11
  },
  "solution_path": [
    "0000000000001000002000410",
    "0000000000001002000000410",
    "0000000000001000000020410",
    "0000000000001000000024010",
    "2000000000001000000004010",
    "0000200000001000000004010",
    "0400200000001000000000010",
    "0420000000001000000000010",
    "0020000000001000000004010",
    "0000000200001000000004010",
    "0000000200001000000000410",
    "0000000200001000040000010"
  ]
}
