{
  "puzzle_info": {
    "grid_width": 4,
    "grid_height": 4,
    "steps_to_solve": 11
  },
  "solution_path": [
    "0201200000004100",
    "0001200002004100",
    "0001200000024100",
    "0001200200004100",
    "0001220000004100",
    "0001220040000100",
    "0001220000040100",
    "0001220400000100",
    "0001224000000100",
    "0201204000000100",
    "0201024000000100",
    "0201004002000100"
  ]
}
