{
  "puzzle_info": {
    "grid_width": 4,
    "grid_height": 4,
    "steps_to_solve": 12
  },
  "solution_path": [
    "0200300000003000",
    "0200000300003000",
    "0200000000003003",
    "0200000000003300",
    "0200030000003000",
    "0200030000000003",
    "0203030000000000",
    "0023030000000000",
    "0003030000000020",
    "3000030000000020",
    "0000030000003020",
    "0000030000000320",
    "0020030000000300"
  ]
}
