{
  "puzzle_info": {
    "grid_width": 4,
    "grid_height": 4,
    "steps_to_solve": 12
  },
  "solution_path": [
    "0400000400200040",
    "4000000400200040",
    "4000000420000040",
    "4000200400000040",
    "4000002400000040",
    "4000002000000044",
    "4000002000400004",
    "4000002000404000",
    "0000002040404000",
    "0000200040404000",
    "0000200004404000",
    "0000200044400000",
    "2000000044400000"
  ]
}
