{
  "puzzle_info": {
    "grid_width": 5,
    "grid_height": 5,
    "steps_to_solve": 18
  },
  "solution_path": [
    "0000040020000000000000032",
    "0000000020000000000040032",
    "0000000020000000000000432",
    "0000000020000300000000402",
    "0000000020300000000000402",
    "0000000020300000000000420",
    "0040000020300000000000020",
    "0040000020300200000000000",
    "0040020000300200000000000",
    "0040020000003200000000000",
    "0000020400003200000000000",
    "0000024000003200000000000",
    "0000004000003200000020000",
    "0000004000000200000020300",
    "0000004000000200000002300",
    "0000004000020200000000300",
    "0000004000002200000000300",
    "0000004000002200030000000",
    "0000004000200200030000000"
  ]
}
