{
  "puzzle_info": {
    "grid_width": 4,
    "grid_height": 4,
    "steps_to_solve": 10
  },
  "solution_path": [
    "0000030000100410",
    "0000300000100410",
    "0400300000100010",
    "0004300000100010",
    "0000300000100014",
    "0000000300100014",
    "0000000300140010",
    "0000300000140010",
    "0000000000143010",
    "0000000000140310",
    "0300000000140010"
  ]
}
