{
  "puzzle_info": {
    "grid_width": 5,
    "grid_height": 5,
    "steps_to_solve": 21
  },
  "solution_path": [
    "0100000000400000000020120",
    "0100000000000040000020120",
    "0100000000000040000002120",
    "0100002000000040000000120",
    "0102002000000040000000100",
    "0100202000000040000000100",
    "0100002002000040000000100",
    "0100000022000040000000100",
    "0100000022000000000000104",
    "0100000022000000000000140",
    "0100000022000400000000100",
    "0100020002000400000000100",
    "0100022000000400000000100",
    "0100002000000400000020100",
    "0100002000000400000002100",
    "0100002000020400000000100",
    "0100000002020400000000100",
    "0100000000020400000000102",
    "0100000000020400000000120",
    "0100000000020400002000100",
    "0100000000024000002000100",
    "0100000000204000002000100"
  ]
}
