{
  "puzzle_info": {
    "grid_width": 5,
    "grid_height": 5,
    "steps_to_solve": 16
  },
  "solution_path": [
    "0000320000000000000400000",
    "0000320000000004000000000",
    "0000020000000004000000003",
    "0000020000400000000000003",
    "0000000002400000000000003",
    "0000000000400000000200003",
    "0000000000400000000230000",
    "0000000000400003000200000",
    "0000000000400000003200000",
    "0000000000400000003000002",
    "0000000000400000003020000",
    "0000000000400002003000000",
    "0000000000400000023000000",
    "0003000000400000020000000",
    "3000000000400000020000000",
    "0000030000400000020000000",
    "0000030000000040020000000"
  ]
}
