{
  "puzzle_info": {
    "grid_width": 5,
    "grid_height": 5,
    "steps_to_solve": 17
  },
  "solution_path": [
    "0004000000100033010000000",
    "0004000000100003010000003",
    "0004000000100000010030003",
    "0004000000100000010000033",
    "0004000030100000010000003",
    "0000400030100000010000003",
    "0000400033100000010000000",
    "4000000033100000010000000",
    "0000040033100000010000000",
    "0000000433100000010000000",
    "0000000403100000010000030",
    "0000000430100000010000030",
    "0000000430100300010000000",
    "0000000403100300010000000",
    "0000000400100300010000003",
    "0000000400100300010030000",
    "0000000400100303010000000",
    "0000000400100300310000000"
  ]
}
