{
  "puzzle_info": {
    "grid_width": 4,
    "grid_height": 4,
    "steps_to_solve": 12
  },
  "solution_path": [
    "0000400030030000",
    "0000000430030000",
    "0000000433000000",
    "0000000403003000",
    "0000000403000003",
    "0000000003040003",
    "0000000003400003",
    "0300000000400003",
    "0303000000400000",
    "0330000000400000",
    "0030000000400300",
    "0000003000400300",
    "0000003040000300"
  ]
}
