{
  "puzzle_info": {
    "grid_width": 4,
    "grid_height": 4,
    "steps_to_solve": 11
  },
  "solution_path": [
    "0000030440000030",
    "0000300440000030",
    "0000340040000030",
    "0000340000040030",
    "0000040000043030",
    "0000040000040330",
    "0000040003040030",
    "0400000003040030",
    "0430000003040000",
    "0430000003400000",
    "0400003003400000",
    "0400003003000040"
  ]
}
