{
  "puzzle_info": {
    "grid_width": 4,
    "grid_height": 4,
    "steps_to_solve": 11
  },
  "solution_path": [
    "0000440003000004",
    "0400400003000004",
    "0400430000000004",
    "0004430000000004",
    "0000430000040004",
    "0000430000044000",
    "0000030040044000",
    "0000300040044000",
    "0000300000444000",
    "0000300040440000",
    "3000000040440000",
    "0003000040440000"
  ]
}
