{
  "puzzle_info": {
    "grid_width": 5,
    "grid_height": 5,
    "steps_to_solve": 16
  },
  "solution_path": [
    "0000000400340000100400010",
    "0040000000340000100400010",
    "3040000000040000100400010",
    "3400000000040000100400010",
    "3000004000040000100400010",
    "0000304000040000100400010",
    "0000004000040030100400010",
    "0000004000000430100400010",
    "0000304000000400100400010",
    "0000304000000400140000010",
    "0040304000000400100000010",
    "0043004000000400100000010",
    "0040004030000400100000010",
    "0040004030000000104000010",
    "0040004030000000140000010",
    "0000004030004000140000010",
    "0000004030004000100400010"
  ]
}
