{
  "puzzle_info": {
    "grid_width": 4,
    "grid_height": 4,
    "steps_to_solve": 13
  },
  "solution_path": [
    "4001100020000003",
    "0041100020000003",
    "0041100000002003",
    "0041100000000023",
    "0001100000400023",
    "0001100300400020",
    "0001130000400020",
    "0301100000400020",
    "0031100000400020",
    "0001103000400020",
    "0001103040000020",
    "0001103040200000",
    "0001103004200000",
    "0001103004000020"
  ]
}
