{
  "puzzle_info": {
    "grid_width": 4,
    "grid_height": 4,
    "steps_to_solve": 13
  },
  "solution_path": [
    "4000020000040300",
    "0004020000040300",
    "0000020400040300",
    "0000002400040300",
    "0000002440000300",
    "0000002440000003",
    "0000002040040003",
    "0000002044000003",
    "0000002040000403",
    "0000002040000430",
    "0400002040000030",
    "0400002040300000",
    "0400002004300000",
    "0400002004030000"
  ]
}
