{
  "puzzle_info": {
    "grid_width": 5,
    "grid_height": 5,
    "steps_to_solve": 19
  },
  "solution_path": [
    "0000040000003000020040000",
    "4000000000003000020040000",
    "0000400000003000020040000",
    "0000400000003000000040200",
    "0000400000003000000004200",
    "0400400000003000000000200",
    "0440000000003000000000200",
    "0040000000003000000004200",
    "0000000400003000000004200",
    "0000000400300000000004200",
    "0000000400302000000004000",
    "0000000400032000000004000",
    "0000000400002000300004000",
    "0000000400000020300004000",
    "0000000400000020300000004",
    "0000000400000020300400000",
    "0000000400000020340000000",
    "0000000400004020300000000",
    "0000000400004200300000000",
    "0000000400400200300000000"
  ]
}
