{
  "puzzle_info": {
    "grid_width": 4,
    "grid_height": 4,
    "steps_to_solve": 13
  },
  "solution_path": [
    "0004030400000002",
    "0004300400000002",
    "0004340000000002",
    "0004040000003002",
    "0004040000000032",
    "0004040200000030",
    "4000040200000030",
    "0000040200004030",
    "0000042000004030",
    "0000042000000430",
    "0000042004000030",
    "0400002004000030",
    "0400002004300000",
    "0400002004030000"
  ]
}
