{
  "puzzle_info": {
    "grid_width": 5,
    "grid_height": 5,
    "steps_to_solve": 16
  },
  "solution_path": [
    "0003400030300000100000000",
    "3000400030300000100000000",
    "0000430030300000100000000",
    "0000030030300000100000004",
    "0000033000300000100000004",
    "3000003000300000100000004",
    "0000303000300000100000004",
    "0000003000300000100300004",
    "0000003000000030100300004",
    "0000003000000030130000004",
    "0000003000000030130400000",
    "0000003000300000130400000",
    "0000003000300000134000000",
    "0000003000300000104000300",
    "0000003000300000104030000",
    "0000003000300003104000000",
    "0000003000000033104000000"
  ]
}
