{
  "puzzle_info": {
    "grid_width": 4,
    "grid_height": 4,
    "steps_to_solve": 16
  },
  "solution_path": [
    "4000410013000004",
    "0004410013000004",
    "4004010013000004",
    "0044010013000004",
    "0040010013040004",
    "0040010013044000",
    "0000010013044040",
    "0000010010344040",
    "0030010010044040",
    "3000010010044040",
    "3000010010040440",
    "3040010010040400",
    "0340010010040400",
    "0304010010040400",
    "0300010410040400",
    "0300014010040400",
    "0300014014000400"
  ]
}
