{
  "puzzle_info": {
    "grid_width": 4,
    "grid_height": 4,
    "steps_to_solve": 12
  },
  "solution_path": [
    "3004003000000000",
    "3000003000000004",
    "3000003000004000",
    "3000403000000000",
    "3000430000000000",
    "3000030000004000",
    "0000030030004000",
    "0000030000034000",
    "4000030000030000",
    "0004030000030000",
    "0000030400030000",
    "0000034000030000",
    "0000030000030040"
  ]
}
