{
  "puzzle_info": {
    "grid_width": 5,
    "grid_height": 5,
    "steps_to_solve": 19
  },
  "solution_path": [
    "2300000000000100002000130",
    "0300000000000100002020130",
    "0300000000000102000020130",
    "0300000000000102000002130",
    "0300000000000102003002100",
    "0300000000000102300002100",
    "0300003000000102000002100",
    "0300003000000100000202100",
    "0300203000000100000002100",
    "0003203000000100000002100",
    "0000203030000100000002100",
    "0000203030020100000000100",
    "0000200330020100000000100",
    "0030200030020100000000100",
    "0032000030020100000000100",
    "3002000030020100000000100",
    "0002000030020100000030100",
    "0002000030020100000003100",
    "0002000030020100300000100",
    "0002000030200100300000100"
  ]
}
