{
  "puzzle_info": {
    "grid_width": 5,
    "grid_height": 5,
    "steps_to_solve": 19
  },
  "solution_path": [
    "2000000003000000000400002",
    "0000000003000000000420002",
    "0000000000000030000420002",
    "0000000000000034000020002",
    "0000000000000034000000022",
    "0000000000000034000200020",
    "0000000000000034200000020",
    "0000000000000030200040020",
    "0000000000000030200000420",
    "0040000000000030200000020",
    "0040000000000030200000002",
    "0040000000000030200200000",
    "0040000000000030220000000",
    "0000000000004030220000000",
    "0000000000004300220000000",
    "0000000000400300220000000",
    "0020000000400300200000000",
    "0020000000004300200000000",
    "0000000200004300200000000",
    "0000000200000300200000400"
  ]
}
