{
  "puzzle_info": {
    "grid_width": 4,
    "grid_height": 4,
    "steps_to_solve": 13
  },
  "solution_path": [
    "0001000200040000",
    "0001000240000000",
    "4001000200000000",
    "0041000200000000",
    "0001000200000040",
    "0001200000000040",
    "2001000000000040",
    "0021000000000040",
    "0001000000200040",
    "0001000000204000",
    "4001000000200000",
    "0041000000200000",
    "0001004000200000",
    "0001004000020000"
  ]
}
