{
  "puzzle_info": {
    "grid_width": 4,
    "grid_height": 4,
    "steps_to_solve": 12
  },
  "solution_path": [
    "0000000300400400",
    "0000300000400400",
    "0000300000404000",
    "0000000030404000",
    "0000000034004000",
    "3000000004004000",
    "3000400004000000",
    "0003400004000000",
    "0000400004000003",
    "0000000404000003",
    "0000000404030000",
    "0000400004030000",
    "0000400004300000"
  ]
}
