{
  "puzzle_info": {
    "grid_width": 4,
    "grid_height": 4,
    "steps_to_solve": 13
  },
  "solution_path": [
    "0000000200440000",
    "0002000000440000",
    "2000000000440000",
    "2004000000400000",
    "0024000000400000",
    "0020000000400004",
    "0020004000000004",
    "0002004000000004",
    "0000004000020004",
    "0000004020000004",
    "0004004020000000",
    "4000004020000000",
    "0000404020000000",
    "0000044020000000"
  ]
}
