{
  "puzzle_info": {
    "grid_width": 5,
    "grid_height": 5,
    "steps_to_solve": 17
  },
  "solution_path": [
    "1003000434000000001000000",
    "1300000434000000001000000",
    "1000000434000000001003000",
    "1000040034000000001003000",
    "1000043004000000001003000",
    "1000003004000000001043000",
    "1000003000000000001043004",
    "1000003000030000001040004",
    "1000000003030000001040004",
    "1000000000030000001340004",
    "1000000000030000001344000",
    "1000040000030000001304000",
    "1000000004030000001304000",
    "1000400000030000001304000",
    "1400000000030000001304000",
    "1000004000030000001304000",
    "1000004000000000301304000",
    "1000004000000003001304000"
  ]
}
