{
  "puzzle_info": {
    "grid_width": 4,
    "grid_height": 4,
    "steps_to_solve": 12
  },
  "solution_path": [
    "0002200000400000",
    "2002000000400000",
    "2042000000000000",
    "2402000000000000",
    "2420000000000000",
    "2020000000000400",
    "0220000000000400",
    "0020000002000400",
    "0020000002004000",
    "4020000002000000",
    "0420000002000000",
    "0020040002000000",
    "0020040000020000"
  ]
}
