{
  "puzzle_info": {
    "grid_width": 4,
    "grid_height": 4,
    "steps_to_solve": 13
  },
  "solution_path": [
    "2030300000000000",
    "0230300000000000",
    "0030300000000200",
    "3030000000000200",
    "0330000000000200",
    "0330000000000002",
    "0030000000000302",
    "0030000000000320",
    "0030002000000300",
    "0003002000000300",
    "0000002000000303",
    "0000002000000330",
    "0000002000300300",
    "0000000200300300"
  ]
}
