{
  "puzzle_info": {
    "grid_width": 4,
    "grid_height": 4,
    "steps_to_solve": 10
  },
  "solution_path": [
    "0404000003000000",
    "0404000000000300",
    "0004000004000300",
    "0004000004000003",
    "0000000004040003",
    "0000000004400003",
    "0000000040400003",
    "0003000040400000",
    "3000000040400000",
    "0000300040400000",
    "0000300004400000"
  ]
}
