{
  "puzzle_info": {
    "grid_width": 4,
    "grid_height": 4,
    "steps_to_solve": 10
  },
  "solution_path": [
    "0000021000010030",
    "0000201000010030",
    "0000201000013000",
    "0000001020013000",
    "0000001000213000",
    "3000001000210000",
    "3000001020010000",
    "0000301020010000",
    "0000031020010000",
    "0000031000210000",
    "0000031000010020"
  ]
}
