{
  "puzzle_info": {
    "grid_width": 4,
    "grid_height": 4,
    "steps_to_solve": 13
  },
  "solution_path": [
    "0023000100000000",
    "2003000100000000",
    "2300000100000000",
    "2000000100000300",
    "2000000100003000",
    "0000000120003000",
    "0000000120000003",
    "0000000120030000",
    "0000000123000000",
    "0000000103002000",
    "0000000103000002",
    "0000000103020000",
    "0000000103200000",
    "0020000103000000"
  ]
}
