{
  "puzzle_info": {
    "grid_width": 4,
    "grid_height": 4,
    "steps_to_solve": 10
  },
  "solution_path": [
    "0102000201000002",
    "0102200001000002",
    "0100200001020002",
    "0100200001200002",
    "0100200001202000",
    "0100000021202000",
    "0100000021200002",
    "0102000021200000",
    "0120000021200000",
    "0100002021200000",
    "0100002021020000"
  ]
}
