{
  "puzzle_info": {
    "grid_width": 4,
    "grid_height": 4,
    "steps_to_solve": 12
  },
  "solution_path": [
    "2003020000000000",
    "0023020000000000",
    "0003020000000020",
    "3000020000000020",
    "0000020000003020",
    "0200000000003020",
    "0200000000000320",
    "0200030000000020",
    "2000030000000020",
    "0000030000002020",
    "0000030000000220",
    "0000030002000020",
    "0000300002000020"
  ]
}
