{
  "puzzle_info": {
    "grid_width": 5,
    "grid_height": 5,
    "steps_to_solve": 17
  },
  "solution_path": [
    "0040030000000000000011000",
    "0000430000000000000011000",
    "0000400003000000000011000",
    "0000400000000000000011003",
    "0000400000000000000011300",
    "0000000000000000000011304",
    "0030000000000000000011004",
    "0030000000000000000011400",
    "0030000400000000000011000",
    "0000300400000000000011000",
    "0000000400000000000011003",
    "0000000400000000000011300",
    "0000000400003000000011000",
    "0000000004003000000011000",
    "0000000000003000000011004",
    "0000000000003000000011400",
    "0000000000003000040011000",
    "0030000000000000040011000"
  ]
}
