{
  "puzzle_info": {
    "grid_width": 4,
    "grid_height": 4,
    "steps_to_solve": 11
  },
  "solution_path": [
    "0003004004030000",
    "3000004004030000",
    "0000004004033000",
    "0000400004033000",
    "0000400004303000",
    "0030400004003000",
    "0030400000043000",
    "0030400030040000",
    "0030400000340000",
    "0000403000340000",
    "0000043000340000",
    "0030040000340000"
  ]
}
