{
  "puzzle_info": {
    "grid_width": 5,
    "grid_height": 5,
    "steps_to_solve": 19
  },
  "solution_path": [
    "0012000340000000200010000",
    "0010200340000000200010000",
    "0010000340000000200010002",
    "0010000040000000200010302",
    "0010000040000000200010032",
    "0010000000000000204010032",
    "0010000000000000024010032",
    "0010000000000000024013002",
    "0310000000000000024010002",
    "0310000000000000024012000",
    "0310002000000000024010000",
    "3010002000000000024010000",
    "0010002000000003024010000",
    "0010002000000000324010000",
    "0010002200000000304010000",
    "0010002002000000304010000",
    "0010202000000000304010000",
    "0012002000000000304010000",
    "0010002000000200304010000",
    "0010002000000200300010040"
  ]
}
