{
  "puzzle_info": {
    "grid_width": 4,
    "grid_height": 4,
    "steps_to_solve": 12
  },
  "solution_path": [
    "4030000000000033",
    "4000000000300033",
    "4003000000300030",
    "0043000000300030",
    "0003004000300030",
    "3000004000300030",
    "3000004030000030",
    "0000304030000030",
    "0000034030000030",
    "0000034030300000",
    "0040030030300000",
    "0040030003300000",
    "0040030003030000"
  ]
}
