{
  "puzzle_info": {
    "grid_width": 4,
    "grid_height": 4,
    "steps_to_solve": 12
  },
  "solution_path": [
    "3003000000003000",
    "0003000030003000",
    "3000000030003000",
    "3000000000033000",
    "3000300000030000",
    "0003300000030000",
    "0000300300030000",
    "0000330000030000",
    "3000030000030000",
    "0003030000030000",
    "0000030300030000",
    "0000033000030000",
    "0000030000030030"
  ]
}
