{
  "puzzle_info": {
    "grid_width": 5,
    "grid_height": 5,
    "steps_to_solve": 17
  },
  "solution_path": [
    "0000300000000010200000100",
    "0200300000000010000000100",
    "2000300000000010000000100",
    "2300000000000010000000100",
    "0300000000000010000020100",
    "0300000000000010000002100",
    "0300002000000010000000100",
    "0000302000000010000000100",
    "0000002003000010000000100",
    "0000002300000010000000100",
    "0200000300000010000000100",
    "0000200300000010000000100",
    "0000000302000010000000100",
    "0000000320000010000000100",
    "0000000300000010000000120",
    "0000000300000010000000102",
    "0000000300000010000200100",
    "0000000300000012000000100"
  ]
}
