{
  "puzzle_info": {
    "grid_width": 4,
    "grid_height": 4,
    "steps_to_solve": 12
  },
  "solution_path": [
    "0010400000000002",
    "4010000000000002",
    "0410000000000002",
    "0410000000002000",
    "0010000000002400",
    "2010000000000400",
    "0210000000000400",
    "0010000002000400",
    "0010000002004000",
    "4010000002000000",
    "0410000002000000",
    "0010040002000000",
    "0010040000020000"
  ]
}
