{
  "puzzle_info": {
    "grid_width": 5,
    "grid_height": 5,
    "steps_to_solve": 18
  },
  "solution_path": [
    "4000000000300040000000002",
    "4000030000000040000000002",
    "4000030000000040000020000",
    "4000030000200040000000000",
    "4000000003200040000000000",
    "0000040003200040000000000",
    "0000043000200040000000000",
    "0000043000000240000000000",
    "0000003000000240000040000",
    "0000003000000200000040004",
    "0000003000000200000044000",
    "4000003000000200000004000",
    "0000403000000200000004000",
    "0000003000000200000004004",
    "0000003000000200000004400",
    "0000003000040200000000400",
    "0000003000004200000000400",
    "0000003000004200040000000",
    "0000003000400200040000000"
  ]
}
