{
  "puzzle_info": {
    "grid_width": 5,
    "grid_height": 5,
    "steps_to_solve": 15
  },
  "solution_path": [
    "0030000010000002300000010",
    "2030000010000000300000010",
    "2300000010000000300000010",
    "2000000010030000300000010",
    "0000200010030000300000010",
    "0000200010030000000300010",
    "0000000010030020000300010",
    "0000000010032000000300010",
    "0300000010002000000300010",
    "0000300010002000000300010",
    "0000300013002000000000010",
    "3000000013002000000000010",
    "0000000013002000000030010",
    "0000000013002000000000310",
    "0000000013002000030000010",
    "0020000013000000030000010"
  ]
}
