{
  "puzzle_info": {
    "grid_width": 4,
    "grid_height": 4,
    "steps_to_solve": 12
  },
  "solution_path": [
    "0000000000022022",
    "0002000000002022",
    "0002000000000222",
    "0002000200000220",
    "2000000200000220",
    "2020000200000200",
    "0220000200000200",
    "0020000202000200",
    "0020000202000002",
    "0020000202020000",
    "0020200002020000",
    "0020200002200000",
    "0000202002200000"
  ]
}
