{
  "puzzle_info": {
    "grid_width": 5,
    "grid_height": 5,
    "steps_to_solve": 9
  },
  "solution_path": [
    "0000000000400000000030000",
    "0000000000000040000030000",
    "3000000000000040000000000",
    "0000300000000040000000000",
    "0000300004000000000000000",
    "3000000004000000000000000",
    "0000000004000000000030000",
    "0000040000000000000030000",
    "0000040000300000000000000",
    "0000040000000030000000000"
  ]
}
