{
  "puzzle_info": {
    "grid_width": 4,
    "grid_height": 4,
    "steps_to_solve": 11
  },
  "solution_path": [
    "0004030000000404",
    "4000030000000404",
    "4000030004000004",
    "4004030004000000",
    "4400030004000000",
    "0400030004004000",
    "0400000304004000",
    "0000040304004000",
    "0000040304000004",
    "0000040304040000",
    "0000043004040000",
    "0000403004040000"
  ]
}
