{
  "puzzle_info": {
    "grid_width": 4,
    "grid_height": 4,
    "steps_to_solve": 13
  },
  "solution_path": [
    "0002400000000003",
    "2000400000000003",
    "2000400000003000",
    "2000000040003000",
    "0000200040003000",
    "0000200000043000",
    "0000200030040000",
    "0000000230040000",
    "0000000234000000",
    "0000000204003000",
    "0000000204000003",
    "0000000204030000",
    "0000000204300000",
    "0000000200300400"
  ]
}
