{
  "puzzle_info": {
    "grid_width": 4,
    "grid_height": 4,
    "steps_to_solve": 12
  },
  "solution_path": [
    "0300000000030002",
    "0300000030000002",
    "0300000000003002",
    "0300000000003200",
    "0300020000003000",
    "0003020000003000",
    "0003020000000003",
    "0003020300000000",
    "0003023000000000",
    "0000023000000003",
    "0000003000000203",
    "0000003000000230",
    "0000003000300200"
  ]
}
