{
  "puzzle_info": {
    "grid_width": 4,
    "grid_height": 4,
    "steps_to_solve": 12
  },
  "solution_path": [
    "0000304040000300",
    "0000340040000300",
    "0000300044000300",
    "0000000344000300",
    "0000000344000003",
    "0000000044030003",
    "0000000044300003",
    "0400000040300003",
    "0400000004300003",
    "0403000004300000",
    "0430000004300000",
    "0030040004300000",
    "0030040000300400"
  ]
}
