{
  "puzzle_info": {
    "grid_width": 4,
    "grid_height": 4,
    "steps_to_solve": 14
  },
  "solution_path": [
    "3000400000000402",
    "0003400000000402",
    "0000400000030402",
    "0000400000034002",
    "0000400000034200",
    "0000400040030200",
    "0000000440030200",
    "0200000440030000",
    "0200000443000000",
    "0000020443000000",
    "0000024043000000",
    "0000024040000300",
    "0000024000040300",
    "0000024003040000",
    "0200004003040000"
  ]
}
