{
  "puzzle_info": {
    "grid_width": 4,
    "grid_height": 4,
    "steps_to_solve": 10
  },
  "solution_path": [
    "0404010000100000",
    "4004010000100000",
    "0004010000104000",
    "0000010000104004",
    "0000010000104400",
    "4000010000100400",
    "4000010004100000",
    "4000010040100000",
    "0000410040100000",
    "0000410004100000",
    "0000410000100400"
  ]
}
