{
  "puzzle_info": {
    "grid_width": 4,
    "grid_height": 4,
    "steps_to_solve": 14
  },
  "solution_path": [
    "0013000400000200",
    "0013400000000200",
    "0010400000000203",
    "0010400000000230",
    "0010403000000200",
    "0010043000000200",
    "0010003004000200",
    "0010300004000200",
    "3010000004000200",
    "0310000004000200",
    "0010030004000200",
    "0010030000040200",
    "0010030002040000",
    "0010030002400000",
    "0010030000400200"
  ]
}
