{
  "puzzle_info": {
    "grid_width": 5,
    "grid_height": 5,
    "steps_to_solve": 18
  },
  "solution_path": [
    "0003000000004002400000000",
    "0000000000004002400000030",
    "0000000000000002400000430",
    "0000000000000000400020430",
    "0400000000000000000020430",
    "0400000000000000000024030",
    "0400000000000000000024300",
    "0400004000000000000020300",
    "0400004000000000000002300",
    "0400004000020000000000300",
    "0400000004020000000000300",
    "0000004004020000000000300",
    "0000000044020000000000300",
    "0000000040020000000000304",
    "0000000040020000000000340",
    "0000000040020400000000300",
    "0000000040024000000000300",
    "0000000040024000030000000",
    "0000000040020040030000000"
  ]
}
