{
  "puzzle_info": {
    "grid_width": 4,
    "grid_height": 4,
    "steps_to_solve": 10
  },
  "solution_path": [
    "4000013000000000",
    "0000013000004000",
    "0030010000004000",
    "3000010000004000",
    "0000010030004000",
    "0000010000034000",
    "4000010000030000",
    "0004010000030000",
    "0000010400030000",
    "0000014000030000",
    "0040010000030000"
  ]
}
