{
  "puzzle_info": {
    "grid_width": 4,
    "grid_height": 4,
    "steps_to_solve": 10
  },
  "solution_path": [
    "0000010000020004",
    "0000010020000004",
    "0000010000002004",
    "0000010000002400",
    "2000010000000400",
    "0002010000000400",
    "0002010004000000",
    "0002010000040000",
    "0000010200040000",
    "0000012000040000",
    "0000012040000000"
  ]
}
