{
  "puzzle_info": {
    "grid_width": 4,
    "grid_height": 4,
    "steps_to_solve": 12
  },
  "solution_path": [
    "0002000003003000",
    "2000000003003000",
    "2000000003000003",
    "2000000000000303",
    "2000000000000330",
    "2030000000000300",
    "0230000000000300",
    "0030000002000300",
    "0030000002003000",
    "3030000002000000",
    "0330000002000000",
    "0030030002000000",
    "0030030000020000"
  ]
}
