{
  "puzzle_info": {
    "grid_width": 5,
    "grid_height": 5,
    "steps_to_solve": 16
  },
  "solution_path": [
    "0020000100000002031000004",
    "2000000100000002031000004",
    "2000020100000000031000004",
    "0000220100000000031000004",
    "0000220100003000001000004",
    "0000220100003000001040000",
    "0000220100403000001000000",
    "0000202100403000001000000",
    "0200200100403000001000000",
    "0200200100043000001000000",
    "0200200100040030001000000",
    "0200000102040030001000000",
    "0200000120040030001000000",
    "0200300120040000001000000",
    "0230000120040000001000000",
    "0030002120040000001000000",
    "0030020120040000001000000"
  ]
}
