{
  "puzzle_info": {
    "grid_width": 4,
    "grid_height": 4,
    "steps_to_solve": 10
  },
  "solution_path": [
    "0000041020000000",
    "0400001020000000",
    "4000001020000000",
    "4000201000000000",
    "0004201000000000",
    "0000201000000004",
    "0000201000004000",
    "0000201040000000",
    "0000021040000000",
    "0200001040000000",
    "0200001000040000"
  ]
}
