{
  "puzzle_info": {
    "grid_width": 5,
    "grid_height": 5,
    "steps_to_solve": 19
  },
  "solution_path": [
    "2000330000000000000400000",
    "0002330000000000000400000",
    "0002030000000030000400000",
    "0002000000000030000430000",
    "0002000000300000000430000",
    "0002000000300003000400000",
    "0002000000300000003400000",
    "0000000000300200003400000",
    "0000000000003200003400000",
    "0000400000003200003000000",
    "4000000000003200003000000",
    "4002000000003000003000000",
    "0042000000003000003000000",
    "0002000400003000003000000",
    "0000000400003200003000000",
    "0000000400000200003000300",
    "0000000400200000003000300",
    "0000000400203000003000000",
    "0000000400023000003000000",
    "0000000400020030003000000"
  ]
}
