{
  "puzzle_info": {
    "grid_width": 4,
    "grid_height": 4,
    "steps_to_solve": 14
  },
  "solution_path": [
    "0023000000040300",
    "0003000000040320",
    "0003000000000324",
    "0303000000000024",
    "0330000000000024",
    "0330000000002004",
    "0330000000002400",
    "0030000003002400",
    "2030000003000400",
    "0230000003000400",
    "0030020003000400",
    "0030020000030400",
    "0030020004030000",
    "0030020004300000",
    "0030020000300400"
  ]
}
