{
  "puzzle_info": {
    "grid_width": 4,
    "grid_height": 4,
    "steps_to_solve": 12
  },
  "solution_path": [
    "0000403030020011",
    "4000003030020011",
    "4000000330020011",
    "4000000300023011",
    "4000000320003011",
    "4000200300003011",
    "4000002300003011",
    "4000302300000011",
    "4000032300000011",
    "0000032300004011",
    "0000032300000411",
    "0000032304000011",
    "0000302304000011"
  ]
}
