{
  "puzzle_info": {
    "grid_width": 4,
    "grid_height": 4,
    "steps_to_solve": 12
  },
  "solution_path": [
    "0000004000001022",
    "0000004000001202",
    "0000000000001242",
    "0200000000001042",
    "0200000000001402",
    "0200040000001002",
    "0002040000001002",
    "0002040200001000",
    "0002042000001000",
    "0000042000001002",
    "0000042000001200",
    "0000042002001000",
    "0400002002001000"
  ]
}
