{
  "puzzle_info": {
    "grid_width": 4,
    "grid_height": 4,
    "steps_to_solve": 12
  },
  "solution_path": [
    "0000430000000003",
    "0300400000000003",
    "3000400000000003",
    "3000000400000003",
    "3000000400030000",
    "3000000430000000",
    "0000300430000000",
    "0000003430000000",
    "0004003030000000",
    "4000003030000000",
    "0000403030000000",
    "0000043030000000",
    "0400003030000000"
  ]
}
