{
  "puzzle_info": {
    "grid_width": 4,
    "grid_height": 4,
    "steps_to_solve": 10
  },
  "solution_path": [
    "0000001001000033",
    "0000001001003003",
    "3000001001000003",
    "3003001001000000",
    "3300001001000000",
    "0300001001003000",
    "0000031001003000",
    "0000301001003000",
    "0000301031000000",
    "0000031031000000",
    "0300001031000000"
  ]
}
