{
  "puzzle_info": {
    "grid_width": 4,
    "grid_height": 4,
    "steps_to_solve": 10
  },
  "solution_path": [
    "0000032000311030",
    "0000032030011030",
    "0000030030211030",
    "0000030032011030",
    "3000030002011030",
    "3030030002011000",
    "0330030002011000",
    "0303030002011000",
    "0300030302011000",
    "0300033002011000",
    "0300303002011000"
  ]
}
