{
  "puzzle_info": {
    "grid_width": 4,
    "grid_height": 4,
    "steps_to_solve": 11
  },
  "solution_path": [
    "0040304001030000",
    "0040034001030000",
    "0040030001030040",
    "0040030001300040",
    "0040033001000040",
    "4000033001000040",
    "0000033001004040",
    "0000303001004040",
    "0000003031004040",
    "0000003031000440",
    "0000003031400400",
    "0000003031040400"
  ]
}
