{
  "puzzle_info": {
    "grid_width": 4,
    "grid_height": 4,
    "steps_to_solve": 10
  },
  "solution_path": [
    "0000000004004040",
    "4000000004000040",
    "4040000004000000",
    "0440000004000000",
    "0040040004000000",
    "0004040004000000",
    "0004040000040000",
    "0000040400040000",
    "0000044000040000",
    "0000404000040000",
    "0000404040000000"
  ]
}
