{
  "puzzle_info": {
    "grid_width": 4,
    "grid_height": 4,
    "steps_to_solve": 12
  },
  "solution_path": [
    "0200000020300003",
    "0002000020300003",
    "0000000020320003",
    "0000000023020003",
    "0300000020020003",
    "0300000000220003",
    "0302000000200003",
    "0302000300200000",
    "0320000300200000",
    "0020000300200300",
    "0020300000200300",
    "0000302000200300",
    "0000032000200300"
  ]
}
