{
  "puzzle_info": {
    "grid_width": 5,
    "grid_height": 5,
    "steps_to_solve": 18
  },
  "solution_path": [
    "0041200000000100000000400",
    "0041000000000100000000402",
    "0041000400000100000000002",
    "4001000400000100000000002",
    "0001000400000100000040002",
    "0001040000000100000040002",
    "0001040000400100000000002",
    "0001040000004100000000002",
    "0001040000004100000020000",
    "0001040000204100000000000",
    "0001000004204100000000000",
    "0001000004240100000000000",
    "0001000004040100000020000",
    "0001000004040100000000002",
    "0001000004040120000000000",
    "0001040000040120000000000",
    "4001000000040120000000000",
    "0041000000040120000000000",
    "0001000000040120000000400"
  ]
}
