{
  "puzzle_info": {
    "grid_width": 4,
    "grid_height": 4,
    "steps_to_solve": 13
  },
  "solution_path": [
    "2400030000200000",
    "2004030000200000",
    "2004030000020000",
    "2000030400020000",
    "2000003400020000",
    "2000003420000000",
    "0000203420000000",
    "0000023420000000",
    "0000020420000030",
    "0000024020000030",
    "0000024000002030",
    "0000024000000230",
    "0000024000300200",
    "0000020400300200"
  ]
}
