{
  "puzzle_info": {
    "grid_width": 4,
    "grid_height": 4,
    "steps_to_solve": 14
  },
  "solution_path": [
    "2000002020140100",
    "0002002020140100",
    "0022000020140100",
    "2022000000140100",
    "2022000400100100",
    "2022400000100100",
    "2002402000100100",
    "0022402000100100",
    "0020402000100102",
    "0020042000100102",
    "0020040200100102",
    "0020040200120100",
    "0020042000120100",
    "0020402000120100",
    "0020002000124100"
  ]
}
