{
  "puzzle_info": {
    "grid_width": 4,
    "grid_height": 4,
    "steps_to_solve": 12
  },
  "solution_path": [
    "1000004020010004",
    "1000004000012004",
    "1000004000012400",
    "1000204000010400",
    "1000240000010400",
    "1000200004010400",
    "1000000204010400",
    "1002000004010400",
    "1200000004010400",
    "1000020004010400",
    "1000020040010400",
    "1000020044010000",
    "1000020040410000"
  ]
}
