{
  "puzzle_info": {
    "grid_width": 4,
    "grid_height": 4,
    "steps_to_solve": 12
  },
  "solution_path": [
    "0440000040000030",
    "0040000040000430",
    "0040000000040430",
    "0040000000000434",
    "0040003000000404",
    "0040003000000440",
    "0040000000300440",
    "0000004000300440",
    "0000004030000440",
    "0400004030000040",
    "0400004030400000",
    "0400004003400000",
    "0400004003040000"
  ]
}
