{
  "puzzle_info": {
    "grid_width": 5,
    "grid_height": 5,
    "steps_to_solve": 10
  },
  "solution_path": [
    "0000040000200000000000000",
    "4000000000200000000000000",
    "0000400000200000000000000",
    "2000400000000000000000000",
    "2400000000000000000000000",
    "0400000000000000000020000",
    "0400000000000000000000002",
    "0000000000000000000004002",
    "0000000000000000000004200",
    "0400000000000000000000200",
    "4000000000000000000000200"
  ]
}
