{
  "puzzle_info": {
    "grid_width": 4,
    "grid_height": 4,
    "steps_to_solve": 12
  },
  "solution_path": [
    "0202000000003000",
    "0202000000000003",
    "0200000000020003",
    "0002000000020003",
    "0000000200020003",
    "0000000220000003",
    "0000000220030000",
    "0000200020030000",
    "0000200000230000",
    "0000200000200003",
    "0000200000203000",
    "0000200030200000",
    "0000000230200000"
  ]
}
