{
  "puzzle_info": {
    "grid_width": 4,
    "grid_height": 4,
    "steps_to_solve": 12
  },
  "solution_path": [
    "4000000003240000",
    "0004000003240000",
    "0004000030240000",
    "0004000032040000",
    "0004000432000000",
    "4000000432000000",
    "4000300402000000",
    "4000003402000000",
    "4030000402000000",
    "0430000402000000",
    "0030040402000000",
    "0000040402000030",
    "0000044002000030"
  ]
}
