{
  "puzzle_info": {
    "grid_width": 4,
    "grid_height": 4,
    "steps_to_solve": 10
  },
  "solution_path": [
    "0000210000040000",
    "2000010000040000",
    "0002010000040000",
    "0002010400000000",
    "2000010400000000",
    "0000010400002000",
    "0000010400000002",
    "0000010400020000",
    "0000014000020000",
    "0040010000020000",
    "0040010020000000"
  ]
}
