{
  "puzzle_info": {
    "grid_width": 4,
    "grid_height": 4,
    "steps_to_solve": 13
  },
  "solution_path": [
    "0004000000032040",
    "0000000400032040",
    "2000000400030040",
    "2000000430000040",
    "2000300400000040",
    "2000003400000040",
    "0000003400002040",
    "0000003400402000",
    "0030000400402000",
    "0030400000402000",
    "0000403000402000",
    "0000403020400000",
    "0000043020400000",
    "0030040020400000"
  ]
}
