{
  "puzzle_info": {
    "grid_width": 4,
    "grid_height": 4,
    "steps_to_solve": 13
  },
  "solution_path": [
    "2200000020000003",
    "0200200020000003",
    "0200000220000003",
    "0200000200002003",
    "0200000200002300",
    "0200030200002000",
    "0200032000002000",
    "0200302000002000",
    "0200302000000002",
    "0000302000000202",
    "0000032000000202",
    "0000032000000220",
    "0000032002000020",
    "0000302002000020"
  ]
}
