{
  "puzzle_info": {
    "grid_width": 4,
    "grid_height": 4,
    "steps_to_solve": 13
  },
  "solution_path": [
    "0002020430000000",
    "2000020430000000",
    "2000002430000000",
    "2000002030000004",
    "2000302000000004",
    "2000032000000004",
    "0000032000002004",
    "0000302000002004",
    "0000302000000024",
    "0000302000200004",
    "0000302000204000",
    "0000302040200000",
    "0000032040200000",
    "0000030240200000"
  ]
}
