{
  "puzzle_info": {
    "grid_width": 4,
    "grid_height": 4,
    "steps_to_solve": 12
  },
  "solution_path": [
    "0001002000000030",
    "0021000000000030",
    "0021003000000000",
    "0021300000000000",
    "0001300000000020",
    "0001300000000002",
    "0001300200000000",
    "0001320000000000",
    "0001020000003000",
    "0001020000000003",
    "0001020300000000",
    "0001023000000000",
    "0201003000000000"
  ]
}
