{
  "puzzle_info": {
    "grid_width": 4,
    "grid_height": 4,
    "steps_to_solve": 12
  },
  "solution_path": [
    "0040000020000002",
    "0004000020000002",
    "0000000020040002",
    "0000000000240002",
    "0004000000200002",
    "0004000200200000",
    "4000000200200000",
    "0000000200204000",
    "0000200000204000",
    "0000200040200000",
    "0000000240200000",
    "0000000204200000",
    "0400000200200000"
  ]
}
