{
  "puzzle_info": {
    "grid_width": 4,
    "grid_height": 4,
    "steps_to_solve": 11
  },
  "solution_path": [
    "0003030000000200",
    "0000030000000203",
    "0000000003000203",
    "0000000003002003",
    "2000000003000003",
    "0002000003000003",
    "0000000003020003",
    "0000000003200003",
    "0300000000200003",
    "0303000000200000",
    "0330000000200000",
    "3030000000200000"
  ]
}
