{
  "puzzle_info": {
    "grid_width": 5,
    "grid_height": 5,
    "steps_to_solve": 15
  },
  "solution_path": [
    "0000000034001001000400040",
    "0003000004001001000400040",
    "0000300004001001000400040",
    "0000300004001041000000040",
    "0000340000001041000000040",
    "0000040003001041000000040",
    "0000043000001041000000040",
    "0000003000401041000000040",
    "0000003000041041000000040",
    "0000003000001041000004040",
    "0000003000001041000000440",
    "0000003000001041040000040",
    "0004003000001041040000000",
    "0004003000001401040000000",
    "0000003040001401040000000",
    "0000003040001041040000000"
  ]
}
