{
  "puzzle_info": {
    "grid_width": 4,
    "grid_height": 4,
    "steps_to_solve": 12
  },
  "solution_path": [
    "0400000000430004",
    "4000000000430004",
    "4000000000434000",
    "0000000040434000",
    "0000000004434000",
    "0040000004034000",
    "0040000004304000",
    "0000004004304000",
    "4000004004300000",
    "4000004040300000",
    "0000404040300000",
    "0000044040300000",
    "0000040440300000"
  ]
}
