{
  "puzzle_info": {
    "grid_width": 4,
    "grid_height": 4,
    "steps_to_solve": 12
  },
  "solution_path": [
    "4000040000030000",
    "0004040000030000",
    "0004400000030000",
    "0004400300000000",
    "0004430000000000",
    "4004030000000000",
    "0044030000000000",
    "0004030000000040",
    "4000030000000040",
    "0000030000004040",
    "0000030000000440",
    "0000030004000040",
    "0000000304000040"
  ]
}
