{
  "puzzle_info": {
    "grid_width": 4,
    "grid_height": 4,
    "steps_to_solve": 10
  },
  "solution_path": [
    "0000400000020000",
    "4000000000020000",
    "0004000000020000",
    "0004000020000000",
    "2004000000000000",
    "0024000000000000",
    "0004000000000020",
    "4000000000000020",
    "0000000000004020",
    "0000000000000420",
    "0400000000000020"
  ]
}
