{
  "puzzle_info": {
    "grid_width": 4,
    "grid_height": 4,
    "steps_to_solve": 12
  },
  "solution_path": [
    "0000020003000004",
    "0000020000030004",
    "0003020000000004",
    "0003020400000000",
    "3000020400000000",
    "3000002400000000",
    "3004002000000000",
    "3400002000000000",
    "0400002000003000",
    "0400002000000003",
    "0000002000000403",
    "0000002000000430",
    "0400002000000030"
  ]
}
