{
  "puzzle_info": {
    "grid_width": 5,
    "grid_height": 5,
    "steps_to_solve": 20
  },
  "solution_path": [
    "0000000000000001003020034",
    "0003000000000001000020034",
    "0003000000000001000023004",
    "0003000000000001000023400",
    "0303000000000001000020400",
    "0330000000000001000020400",
    "0300000000000001030020400",
    "0300000000000001030002400",
    "0300002000000001030000400",
    "0000302000000001030000400",
    "0000302000000001030000004",
    "0000302004000001030000000",
    "0000302400000001030000000",
    "0000002400000001030000003",
    "0200000400000001030000003",
    "0000200400000001030000003",
    "0000000400000001030200003",
    "0000000400000001032000003",
    "0000000400000001302000003",
    "0000300400000001302000000",
    "3000000400000001302000000"
  ]
}
