{
  "puzzle_info": {
    "grid_width": 4,
    "grid_height": 4,
    "steps_to_solve": 11
  },
  "solution_path": [
    "0000400010030000",
    "4000000010030000",
    "0004000010030000",
    "0004000310000000",
    "4000000310000000",
    "0000400310000000",
    "0000004310000000",
    "0003004010000000",
    "3000004010000000",
    "0000304010000000",
    "0000034010000000",
    "0000030410000000"
  ]
}
