{
  "puzzle_info": {
    "grid_width": 4,
    "grid_height": 4,
    "steps_to_solve": 12
  },
  "solution_path": [
    "0430000400000040",
    "0030000400000440",
    "3000000400000440",
    "3040000400000400",
    "3400000400000400",
    "3000000404000400",
    "0003000404000400",
    "0003000404000004",
    "0003000004040004",
    "0000000304040004",
    "0000000304400004",
    "0000000304440000",
    "0003000004440000"
  ]
}
