{
  "puzzle_info": {
    "grid_width": 5,
    "grid_height": 5,
    "steps_to_solve": 20
  },
  "solution_path": [
    "0000000000002040400000201",
    "0000000000000240400000201",
    "0000400000000200400000201",
    "0400400000000200000000201",
    "0004400000000200000000201",
    "0000400040000200000000201",
    "4000000040000200000000201",
    "4000000040200000000000201",
    "0000040040200000000000201",
    "0000000440200000000000201",
    "0000000440202000000000001",
    "0000000440022000000000001",
    "0000000440020000000000201",
    "0000000440020000000000021",
    "0000000440020200000000001",
    "0004000400020200000000001",
    "4000000400020200000000001",
    "0000000400020200000040001",
    "0000000400020200000000041",
    "0000000400020200004000001",
    "0002000400020000004000001"
  ]
}
