{
  "puzzle_info": {
    "grid_width": 4,
    "grid_height": 4,
    "steps_to_solve": 12
  },
  "solution_path": [
    "0030000000320003",
    "0032000000300003",
    "0032000000030003",
    "0030000200030003",
    "0030000230000003",
    "0030000230030000",
    "0030000233000000",
    "3030000203000000",
    "0330000203000000",
    "0030030203000000",
    "0000030203000030",
    "0000032003000030",
    "0300002003000030"
  ]
}
