{
  "puzzle_info": {
    "grid_width": 5,
    "grid_height": 5,
    "steps_to_solve": 20
  },
  "solution_path": [
    "0310004000000000000200000",
    "3010004000000000000200000",
    "0010004000000000000230000",
    "0010004000000000000030002",
    "0010004000000000000032000",
    "0010000000000000400032000",
    "3010000000000000400002000",
    "0310000000000000400002000",
    "0010000000030000400002000",
    "0010000000030000000402000",
    "0010000000030000200400000",
    "0010000000030000002400000",
    "0010400000030000002000000",
    "0014000000030000002000000",
    "0010000000030400002000000",
    "0010000000030402000000000",
    "2010000000030400000000000",
    "0210000000030400000000000",
    "0010002000030400000000000",
    "0010002000003400000000000",
    "0010002000003040000000000"
  ]
}
