{
  "puzzle_info": {
    "grid_width": 4,
    "grid_height": 4,
    "steps_to_solve": 10
  },
  "solution_path": [
    "0010040000000004",
    "0010040000004000",
    "0010000000004400",
    "4010000000000400",
    "0410000000000400",
    "0010000004000400",
    "0010000004004000",
    "4010000004000000",
    "0410000004000000",
    "0010040004000000",
    "0010040040000000"
  ]
}
