{
  "puzzle_info": {
    "grid_width": 4,
    "grid_height": 4,
    "steps_to_solve": 13
  },
  "solution_path": [
    "0200000020000040",
    "2000000020000040",
    "2000200000000040",
    "0002200000000040",
    "0002200000004000",
    "0002200040000000",
    "0002200000040000",
    "0000200200040000",
    "0000220000040000",
    "2000020000040000",
    "0002020000040000",
    "0000020200040000",
    "0000022000040000",
    "0020020000040000"
  ]
}
