{
  "puzzle_info": {
    "grid_width": 5,
    "grid_height": 5,
    "steps_to_solve": 17
  },
  "solution_path": [
    "0000310000000000000040000",
    "0000310000000000000000004",
    "0000010000000000000300004",
    "0000010000000003000000004",
    "0000010000300000000000004",
    "0000010000000030000000004",
    "0000010000000030000040000",
    "0000010000400030000000000",
    "0000010000000430000000000",
    "0000010000000400000000003",
    "0000010000000400000030000",
    "0000010000300400000000000",
    "0000010000003400000000000",
    "0000010000003000000000040",
    "0000010000003000000040000",
    "0000010000403000000000000",
    "0000010000043000000000000",
    "0000010000040030000000000"
  ]
}
