{
  "puzzle_info": {
    "grid_width": 4,
    "grid_height": 4,
    "steps_to_solve": 12
  },
  "solution_path": [
    "0000340000000003",
    "0000300000000403",
    "0000000300000403",
    "0000000300004003",
    "0000000300034000",
    "0000300000034000",
    "0000300040030000",
    "0000300000430000",
    "0000300000400003",
    "0000300000403000",
    "0000300030400000",
    "0000300003400000",
    "0000300003000040"
  ]
}
