{
  "puzzle_info": {
    "grid_width": 4,
    "grid_height": 4,
    "steps_to_solve": 13
  },
  "solution_path": [
    "0400020000002000",
    "4000020000002000",
    "4000200000002000",
    "4000000020002000",
    "0000400020002000",
    "0000000420002000",
    "0000000420000002",
    "0000000420020000",
    "0000000422000000",
    "0000000402002000",
    "0000000402000002",
    "0000000402020000",
    "0000000402200000",
    "0000000402000020"
  ]
}
