{
  "puzzle_info": {
    "grid_width": 4,
    "grid_height": 4,
    "steps_to_solve": 11
  },
  "solution_path": [
    "0000404030000040",
    "4000004030000040",
    "4000000430000040",
    "4000300400000040",
    "4000003400000040",
    "0000003400004040",
    "0004003000004040",
    "4000003000004040",
    "0000003040004040",
    "0000003040000440",
    "0000003040400400",
    "0000003044000400"
  ]
}
