{
  "puzzle_info": {
    "grid_width": 4,
    "grid_height": 4,
    "steps_to_solve": 12
  },
  "solution_path": [
    "0000000430300000",
    "0000400030300000",
    "0000400000303000",
    "0000000040303000",
    "0000000004303000",
    "0030000004003000",
    "3030000004000000",
    "0330000004000000",
    "0030030004000000",
    "0003030004000000",
    "0003030000040000",
    "0000030300040000",
    "0000030340000000"
  ]
}
