{
  "puzzle_info": {
    "grid_width": 4,
    "grid_height": 4,
    "steps_to_solve": 10
  },
  "solution_path": [
    "0003000401000000",
    "3000000401000000",
    "0000000401003000",
    "0000000401000003",
    "0000000001040003",
    "0000000001400003",
    "0003000001400000",
    "0003000001040000",
    "0000000301040000",
    "0000000301400000",
    "0000000301000040"
  ]
}
