{
  "puzzle_info": {
    "grid_width": 4,
    "grid_height": 4,
    "steps_to_solve": 13
  },
  "solution_path": [
    "0200000300000023",
    "0000000300000223",
    "0003000000000223",
    "3000000000000223",
    "3003000000000220",
    "3300000000000220",
    "0300000000003220",
    "0300020000003020",
    "0300020000000320",
    "0300020003000020",
    "0300000203000020",
    "0000030203000020",
    "0000032003000020",
    "0300002003000020"
  ]
}
