{
  "puzzle_info": {
    "grid_width": 4,
    "grid_height": 4,
    "steps_to_solve": 13
  },
  "solution_path": [
    "0000033000040000",
    "0300003000040000",
    "3000003000040000",
    "3000003040000000",
    "3000403000000000",
    "3000043000000000",
    "0000043000003000",
    "0000040000003030",
    "0000040000000330",
    "0000040003000030",
    "0000000403000030",
    "0000000403000003",
    "0000000403030000",
    "0000400003030000"
  ]
}
