{
  "puzzle_info": {
    "grid_width": 4,
    "grid_height": 4,
    "steps_to_solve": 10
  },
  "solution_path": [
    "0010000004000200",
    "0010000004002000",
    "0010000000002400",
    "2010000000000400",
    "0210000000000400",
    "0010000002000400",
    "0010000002004000",
    "4010000002000000",
    "0410000002000000",
    "0010040002000000",
    "0010040000020000"
  ]
}
