{
  "puzzle_info": {
    "grid_width": 4,
    "grid_height": 4,
    "steps_to_solve": 13
  },
  "solution_path": [
    "0000000040202400",
    "0000000004202400",
    "0000000004002420",
    "0000000004002402",
    "0000000004002042",
    "0040000004002002",
    "0040000004002200",
    "2040000004000200",
    "0240000004000200",
    "0040020004000200",
    "0040020000040200",
    "0040020002040000",
    "0040020002400000",
    "0040020000400200"
  ]
}
