{
  "puzzle_info": {
    "grid_width": 4,
    "grid_height": 4,
    "steps_to_solve": 12
  },
  "solution_path": [
    "0003000020000010",
    "3000000020000010",
    "3000000000002010",
    "3000000000000210",
    "0000000000003210",
    "0200000000003010",
    "0200000000000310",
    "0200030000000010",
    "2000030000000010",
    "0000030000002010",
    "0000030000000210",
    "0000030002000010",
    "0000030000020010"
  ]
}
