{
  "puzzle_info": {
    "grid_width": 4,
    "grid_height": 4,
    "steps_to_solve": 13
  },
  "solution_path": [
    "0000003000020002",
    "0000000300020002",
    "0000000320000002",
    "0000000020030002",
    "0000000000230002",
    "0003000000200002",
    "0003000200200000",
    "3000000200200000",
    "0000000200203000",
    "0000200000203000",
    "0000200030200000",
    "0000000230200000",
    "0000000203200000",
    "0000000200200300"
  ]
}
