{
  "puzzle_info": {
    "grid_width": 4,
    "grid_height": 4,
    "steps_to_solve": 12
  },
  "solution_path": [
    "1000004000002000",
    "1040000000002000",
    "1400000000002000",
    "1400000000000002",
    "1000000000000402",
    "1002000000000400",
    "1200000000000400",
    "1000000002000400",
    "1000000002000004",
    "1004000002000000",
    "1400000002000000",
    "1000040002000000",
    "1000040000020000"
  ]
}
