{
  "puzzle_info": {
    "grid_width": 4,
    "grid_height": 4,
    "steps_to_solve": 12
  },
  "solution_path": [
    "0002020030000000",
    "0002020000030000",
    "0000020200030000",
    "0000002200030000",
    "0000002200000003",
    "0000002000020003",
    "0000002020000003",
    "0003002020000000",
    "3000002020000000",
    "0000302020000000",
    "0000032020000000",
    "0000002020000300",
    "0000002000020300"
  ]
}
