{
  "puzzle_info": {
    "grid_width": 4,
    "grid_height": 4,
    "steps_to_solve": 12
  },
  "solution_path": [
    "0004003030000000",
    "0000003030000004",
    "0000000330000004",
    "0000000030030004",
    "0000000000330004",
    "0003000000300004",
    "0003000400300000",
    "3000000400300000",
    "0000000400303000",
    "0000400000303000",
    "0000400030300000",
    "0000400003300000",
    "0300400000300000"
  ]
}
