{
  "puzzle_info": {
    "grid_width": 4,
    "grid_height": 4,
    "steps_to_solve": 12
  },
  "solution_path": [
    "2000400000040004",
    "0002400000040004",
    "0002400400000004",
    "0002400400040000",
    "0002440000040000",
    "0000440200040000",
    "0000442000040000",
    "0000402000040400",
    "0000042000040400",
    "0000042000000404",
    "0000042000000440",
    "0000042004000040",
    "0400002004000040"
  ]
}
