{
  "puzzle_info": {
    "grid_width": 5,
    "grid_height": 5,
    "steps_to_solve": 19
  },
  "solution_path": [
    "4000004000000000013130000",
    "0000404000000000013130000",
    "0000440000000000013130000",
    "0000440000000000010130030",
    "0000440000300000010100030",
    "0000440000000030010100030",
    "0000440003000000010100030",
    "0000443000000000010100030",
    "4000403000000000010100030",
    "0004403000000000010100030",
    "0000403000000000014100030",
    "4000003000000000014100030",
    "0000003000000000014140030",
    "0000003000000000014143000",
    "0000003000030000014140000",
    "0000003000030000014100004",
    "0000003000000000014103004",
    "0000003000000000014103400",
    "0000003000030000014100400",
    "0000000003030000014100400"
  ]
}
