{
  "puzzle_info": {
    "grid_width": 5,
    "grid_height": 5,
    "steps_to_solve": 18
  },
  "solution_path": [
    "0000203000000000000220000",
    "0000003000000020000220000",
    "0000000000000020000223000",
    "0000000000000020000023002",
    "2000000000000020000003002",
    "2000000000000020000003200",
    "2020000000000020000003000",
    "0220000000000020000003000",
    "0020000000000020200003000",
    "0020000000000020200000003",
    "0020000000000020200300000",
    "0020000000000020230000000",
    "0000000000002020230000000",
    "0000000000002200230000000",
    "0000000000200200230000000",
    "0030000000200200200000000",
    "0030000000002200200000000",
    "0000000300002200200000000",
    "0000000300200200200000000"
  ]
}
