{
  "puzzle_info": {
    "grid_width": 5,
    "grid_height": 5,
    "steps_to_solve": 12
  },
  "solution_path": [
    "0120000200000000001000000",
    "0120000000000000001000200",
    "0100000000000000021000200",
    "0100000000000002001000200",
    "0120000000000002001000000",
    "0120000000000000021000000",
    "0100000000002000021000000",
    "0100000000002000001000200",
    "0100000000002000001000002",
    "0100200000002000001000000",
    "0120000000002000001000000",
    "0100000200002000001000000",
    "0100000200000020001000000"
  ]
}
