{
  "puzzle_info": {
    "grid_width": 4,
    "grid_height": 4,
    "steps_to_solve": 11
  },
  "solution_path": [
    "2010000000010200",
    "0210000000010200",
    "0010000002010200",
    "0010000020010200",
    "0210000020010000",
    "2010000020010000",
    "0010200020010000",
    "0010000220010000",
    "0012000020010000",
    "0012000000210000",
    "0012002000010000",
    "0012000200010000"
  ]
}
