{
  "puzzle_info": {
    "grid_width": 4,
    "grid_height": 4,
    "steps_to_solve": 12
  },
  "solution_path": [
    "2240002000000000",
    "0240002000002000",
    "0204002000002000",
    "0204000000002020",
    "0204000000000220",
    "0204020000000020",
    "0024020000000020",
    "0004020000200020",
    "4000020000200020",
    "4000020000202000",
    "0000020040202000",
    "0000020040200002",
    "0002020040200000"
  ]
}
