{
  "puzzle_info": {
    "grid_width": 4,
    "grid_height": 4,
    "steps_to_solve": 13
  },
  "solution_path": [
    "0032000030301001",
    "0002003030301001",
    "0002300030301001",
    "0002300003301001",
    "0302300000301001",
    "0320300000301001",
    "0020300000301301",
    "0020303000001301",
    "0020303000001031",
    "0020303000301001",
    "0020330000301001",
    "0000332000301001",
    "0000332000001031",
    "0000332000001301"
  ]
}
