{
  "puzzle_info": {
    "grid_width": 4,
    "grid_height": 4,
    "steps_to_solve": 13
  },
  "solution_path": [
    "0000000040040303",
    "4000000000040303",
    "4004000000000303",
    "4004000000000330",
    "4034000000000300",
    "4304000000000300",
    "4340000000000300",
    "4040000003000300",
    "0440000003000300",
    "0040040003000300",
    "0040040000030300",
    "0040040003030000",
    "0040040003300000",
    "0040040030300000"
  ]
}
