{
  "puzzle_info": {
    "grid_width": 5,
    "grid_height": 5,
    "steps_to_solve": 18
  },
  "solution_path": [
    "4000000030000020010000020",
    "4000030000000020010000020",
    "4002030000000020010000000",
    "4000230000000020010000000",
    "0004230000000020010000000",
    "0004030002000020010000000",
    "0004032000000020010000000",
    "3004002000000020010000000",
    "0034002000000020010000000",
    "0004002000003020010000000",
    "0004002000000320010000000",
    "0000002040000320010000000",
    "0000002040000020010000030",
    "0000002040200000010000030",
    "0000002040000000010020030",
    "0000002040000000010000230",
    "0000002040000300010000200",
    "0000002400000300010000200",
    "0000020400000300010000200"
  ]
}
