{
  "puzzle_info": {
    "grid_width": 5,
    "grid_height": 5,
    "steps_to_solve": 16
  },
  "solution_path": [
    "0031000000001000000004003",
    "0001000300001000000004003",
    "0001000003001000000004003",
    "0001000000001000000304003",
    "0001000000001000000304300",
    "0001000000001000030304000",
    "0001000000001000003304000",
    "0001000000001000000304030",
    "0001000000001000000300430",
    "0001000030001000000300400",
    "0001000003001000000300400",
    "0001000000001030000300400",
    "0001000000001300000300400",
    "0001000000001303000000400",
    "0001000000001303040000000",
    "0001000000001300340000000",
    "0001000000001300300000400"
  ]
}
