{
  "puzzle_info": {
    "grid_width": 4,
    "grid_height": 4,
    "steps_to_solve": 10
  },
  "solution_path": [
    "3000000000100400",
    "0000000000103400",
    "0400000000103000",
    "4000000000103000",
    "0000000040103000",
    "0000000004103000",
    "3000000004100000",
    "3000000040100000",
    "0000300040100000",
    "0000000340100000",
    "0000000304100000"
  ]
}
