{
  "puzzle_info": {
    "grid_width": 4,
    "grid_height": 4,
    "steps_to_solve": 12
  },
  "solution_path": [
    "0240000004002000",
    "0200000004002040",
    "0200040000002040",
    "2000040000002040",
    "0000040020002040",
    "0000040000022040",
    "0000040000020240",
    "0000040002020040",
    "0400000002020040",
    "0440000002020000",
    "0440000002200000",
    "0400004002200000",
    "0400004002020000"
  ]
}
