{
  "puzzle_info": {
    "grid_width": 4,
    "grid_height": 4,
    "steps_to_solve": 13
  },
  "solution_path": [
    "0040020300002000",
    "0000020300002040",
    "0000002300002040",
    "0000000300202040",
    "0000300000202040",
    "0000000030202040",
    "0000000030202400",
    "0400000030202000",
    "0400000003202000",
    "0400000003200002",
    "0402000003200000",
    "0420000003200000",
    "0400002003200000",
    "0400002003000020"
  ]
}
