{
  "puzzle_info": {
    "grid_width": 4,
    "grid_height": 4,
    "steps_to_solve": 13
  },
  "solution_path": [
    "0400300400000003",
    "0000300400000403",
    "0004300000000403",
    "0004300300000400",
    "0004330000000400",
    "0004330000000004",
    "0004330400000000",
    "0004334000000000",
    "0000334000000004",
    "0000304000000304",
    "0000034000000304",
    "0000034000000340",
    "0000034003000040",
    "0300004003000040"
  ]
}
