{
  "puzzle_info": {
    "grid_width": 4,
    "grid_height": 4,
    "steps_to_solve": 11
  },
  "solution_path": [
    "0000230003030000",
    "2000030003030000",
    "0002030003030000",
    "0002030000030300",
    "0002030300000300",
    "0002033000000300",
    "0000033000000302",
    "0000033000003002",
    "0000033000003200",
    "0000033002003000",
    "0300003002003000",
    "0300003002000003"
  ]
}
