{
  "puzzle_info": {
    "grid_width": 4,
    "grid_height": 4,
    "steps_to_solve": 13
  },
  "solution_path": [
    "0300000000030202",
    "3000000000030202",
    "3003000000000202",
    "3003000000000220",
    "3023000000000200",
    "3203000000000200",
    "3230000000000200",
    "3030000002000200",
    "0330000002000200",
    "0030030002000200",
    "0030030000020200",
    "0030030002020000",
    "0030030002200000",
    "0030030020200000"
  ]
}
