{
  "puzzle_info": {
    "grid_width": 4,
    "grid_height": 4,
    "steps_to_solve": 11
  },
  "solution_path": [
    "4000000440030000",
    "4000400400030000",
    "0004400400030000",
    "0004440000030000",
    "0004440300000000",
    "0004443000000000",
    "0000443000000004",
    "0000403000000404",
    "0000043000000404",
    "0000043000000440",
    "0000043004000040",
    "0000403004000040"
  ]
}
