{
  "puzzle_info": {
    "grid_width": 4,
    "grid_height": 4,
    "steps_to_solve": 12
  },
  "solution_path": [
    "0000040000002404",
    "0000000004002404",
    "2000000004000404",
    "2000000004000044",
    "2040000004000004",
    "0240000004000004",
    "0204000004000004",
    "0200000004040004",
    "0200000004400004",
    "0204000004400000",
    "0240000004400000",
    "0200004004400000",
    "0200004004040000"
  ]
}
