{
  "puzzle_info": {
    "grid_width": 4,
    "grid_height": 4,
    "steps_to_solve": 13
  },
  "solution_path": [
    "0000300040200003",
    "0000000340200003",
    "0000000342000003",
    "0200000340000003",
    "0200000340030000",
    "0200000343000000",
    "0200000303004000",
    "0200000303000004",
    "0200000003030004",
    "0200000003300004",
    "0204000003300000",
    "0240000003300000",
    "0200004003300000",
    "0200004003000030"
  ]
}
