{
  "puzzle_info": {
    "grid_width": 4,
    "grid_height": 4,
    "steps_to_solve": 13
  },
  "solution_path": [
    "0020000430020000",
    "2000000430020000",
    "2000300400020000",
    "0002300400020000",
    "0002340000020000",
    "0000340200020000",
    "0000300200020400",
    "0000320000020400",
    "3000020000020400",
    "0003020000020400",
    "0000020300020400",
    "0000020304020000",
    "0000020304200000",
    "0000020340200000"
  ]
}
