{
  "puzzle_info": {
    "grid_width": 4,
    "grid_height": 4,
    "steps_to_solve": 12
  },
  "solution_path": [
    "0300000304004000",
    "0000030304004000",
    "0000030004004003",
    "0000030000044003",
    "0000030000040043",
    "0040030000040003",
    "0040030000043000",
    "0000030000043040",
    "0000030000040340",
    "0000030003040040",
    "0040030003040000",
    "0040030003400000",
    "0040030030400000"
  ]
}
