{
  "puzzle_info": {
    "grid_width": 4,
    "grid_height": 4,
    "steps_to_solve": 14
  },
  "solution_path": [
    "0020400000002300",
    "0000400000002320",
    "4000000000002320",
    "0004000000002320",
    "0304000000002020",
    "0340000000002020",
    "0340000000002200",
    "0040000003002200",
    "2040000003000200",
    "0240000003000200",
    "0040020003000200",
    "0040020000030200",
    "0040020002030000",
    "0040020002300000",
    "0040020000300200"
  ]
}
