{
  "puzzle_info": {
    "grid_width": 4,
    "grid_height": 4,
    "steps_to_solve": 13
  },
  "solution_path": [
    "0030004040002000",
    "3000004040002000",
    "0000304040002000",
    "0000340040002000",
    "0000340000042000",
    "0000340020040000",
    "0000340000240000",
    "0000040000243000",
    "0000040000043020",
    "0000040000040320",
    "0000040003040020",
    "0020040003040000",
    "0020040003400000",
    "0020040030400000"
  ]
}
