{
  "puzzle_info": {
    "grid_width": 4,
    "grid_height": 4,
    "steps_to_solve": 14
  },
  "solution_path": [
    "0342000000004000",
    "0042000000004300",
    "0002000000004340",
    "4002000000000340",
    "4200000000000340",
    "0200000000004340",
    "0200030000004040",
    "0200030000000440",
    "0200030004000040",
    "0200000304000040",
    "0000020304000040",
    "0000023004000040",
    "0000023000000440",
    "0000023000400400",
    "0030020000400400"
  ]
}
