{
  "puzzle_info": {
    "grid_width": 4,
    "grid_height": 4,
    "steps_to_solve": 13
  },
  "solution_path": [
    "4004000000033000",
    "0004000040033000",
    "0004000000433000",
    "0004000300403000",
    "0004300000403000",
    "3004000000403000",
    "3400000000403000",
    "0400000030403000",
    "0400000003403000",
    "0400000003400003",
    "0403000003400000",
    "0430000003400000",
    "0400003003400000",
    "0400003003000040"
  ]
}
