{
  "puzzle_info": {
    "grid_width": 4,
    "grid_height": 4,
    "steps_to_solve": 13
  },
  "solution_path": [
    "0000020020300300",
    "0200000020300300",
    "0200000023000300",
    "0200030020000300",
    "0200030000020300",
    "0200000003020300",
    "0200000000320300",
    "0000000002320300",
    "0000000020320300",
    "0300000020320000",
    "0300000023020000",
    "0000030023020000",
    "0000030023200000",
    "0000030020200300"
  ]
}
