{
  "puzzle_info": {
    "grid_width": 4,
    "grid_height": 4,
    "steps_to_solve": 13
  },
  "solution_path": [
    "0000020003304000",
    "0000200003304000",
    "0030200003004000",
    "0030200000034000",
    "0030200040030000",
    "0030200000430000",
    "0030200000400003",
    "0030200000403000",
    "0030000020403000",
    "0030000002403000",
    "3030000002400000",
    "0330000002400000",
    "0300003002400000",
    "0300003002040000"
  ]
}
