{
  "puzzle_info": {
    "grid_width": 4,
    "grid_height": 4,
    "steps_to_solve": 13
  },
  "solution_path": [
    "0000300200000230",
    "3000000200000230",
    "3000000200002030",
    "3000200200000030",
    "3000002200000030",
    "3000002200003000",
    "3000302200000000",
    "3000032200000000",
    "0000032200003000",
    "0000030200003020",
    "0000032000003020",
    "0000032000000320",
    "0000032000200300",
    "0020030000200300"
  ]
}
