{
  "puzzle_info": {
    "grid_width": 4,
    "grid_height": 4,
    "steps_to_solve": 13
  },
  "solution_path": [
    "0000000000002323",
    "2000000000000323",
    "2300000000000023",
    "2303000000000020",
    "2033000000000020",
    "2003000000300020",
    "2003000000302000",
    "0003000020302000",
    "3000000020302000",
    "3000000002302000",
    "0000000032302000",
    "0000000032300002",
    "0002000032300000",
    "2000000032300000"
  ]
}
