{
  "puzzle_info": {
    "grid_width": 4,
    "grid_height": 4,
    "steps_to_solve": 12
  },
  "solution_path": [
    "3000000330000004",
    "0000300330000004",
    "0000300030030004",
    "0000300000330004",
    "0003300000300004",
    "0003300400300000",
    "0003340000300000",
    "0403300000300000",
    "0430300000300000",
    "0030300000300400",
    "0000303000300400",
    "0000033000300400",
    "0030030000300400"
  ]
}
