{
  "puzzle_info": {
    "grid_width": 4,
    "grid_height": 4,
    "steps_to_solve": 12
  },
  "solution_path": [
    "0002000023040000",
    "0000000223040000",
    "0000200023040000",
    "0000200020340000",
    "0000200002340000",
    "0200200000340000",
    "0200200000300004",
    "0200200000304000",
    "0200200040300000",
    "0200000240300000",
    "0200000204300000",
    "0000020204300000",
    "0000020200300400"
  ]
}
