{
  "puzzle_info": {
    "grid_width": 4,
    "grid_height": 4,
    "steps_to_solve": 12
  },
  "solution_path": [
    "2000000000302002",
    "2000000000300022",
    "2002000000300020",
    "0022000000300020",
    "0002002000300020",
    "2000002000300020",
    "2000002030000020",
    "2000302000000020",
    "2000032000000020",
    "0000032000002020",
    "0000032000000220",
    "0000032002000020",
    "0000302002000020"
  ]
}
