{
  "puzzle_info": {
    "grid_width": 4,
    "grid_height": 4,
    "steps_to_solve": 11
  },
  "solution_path": [
    "0000000004400340",
    "0040000004000340",
    "0040004004000300",
    "0040000404000300",
    "0040000404000003",
    "0040000404030000",
    "0040400004030000",
    "0040400004300000",
    "0000404004300000",
    "0000044004300000",
    "0000040404300000",
    "0000040440300000"
  ]
}
