{
  "puzzle_info": {
    "grid_width": 4,
    "grid_height": 4,
    "steps_to_solve": 13
  },
  "solution_path": [
    "4002020030000000",
    "4202000030000000",
    "4022000030000000",
    "4002000030000020",
    "0042000030000020",
    "0002000030400020",
    "0002000003400020",
    "0302000000400020",
    "0320000000400020",
    "0300002000400020",
    "0300002040000020",
    "0300002040200000",
    "0300002004200000",
    "0300002004020000"
  ]
}
