{
  "puzzle_info": {
    "grid_width": 4,
    "grid_height": 4,
    "steps_to_solve": 10
  },
  "solution_path": [
    "3003033000000000",
    "0003033000003000",
    "3000033000003000",
    "0000033030003000",
    "0000030030003030",
    "0000030000033030",
    "0000030000030330",
    "0000030003030030",
    "0300000003030030",
    "0330000003030000",
    "0330000003300000"
  ]
}
