{
  "puzzle_info": {
    "grid_width": 4,
    "grid_height": 4,
    "steps_to_solve": 12
  },
  "solution_path": [
    "0400000300400040",
    "0000000300400440",
    "0000000000400443",
    "0040000000000443",
    "0040004000000403",
    "0040004000000430",
    "0040004000004030",
    "0040004000304000",
    "0040400000304000",
    "0000404000304000",
    "0000404040300000",
    "0000404004300000",
    "0000404004000030"
  ]
}
