{
  "puzzle_info": {
    "grid_width": 4,
    "grid_height": 4,
    "steps_to_solve": 14
  },
  "solution_path": [
    "0300030000040200",
    "0300030040000200",
    "0300000043000200",
    "0000030043000200",
    "0000030040030200",
    "0000030000430200",
    "0000030002430000",
    "0000030020430000",
    "0000000020430300",
    "0000000024030300",
    "0000000024300300",
    "0400000020300300",
    "0400000002300300",
    "0000040002300300",
    "0000040002030300"
  ]
}
