{
  "puzzle_info": {
    "grid_width": 4,
    "grid_height": 4,
    "steps_to_solve": 14
  },
  "solution_path": [
    "0030000430000020",
    "0000000430300020",
    "0004000030300020",
    "0004000003300020",
    "0304000000300020",
    "0340000000300020",
    "0340003000000020",
    "0340300000000020",
    "0300300000400020",
    "0300300000402000",
    "0300300020400000",
    "0300000320400000",
    "0300000302400000",
    "0000030302400000",
    "0000030320400000"
  ]
}
