{
  "puzzle_info": {
    "grid_width": 4,
    "grid_height": 4,
    "steps_to_solve": 12
  },
  "solution_path": [
    "3300000000000403",
    "0300000000003403",
    "0300040000003003",
    "0300040000003300",
    "0300000004003300",
    "0000030004003300",
    "0000030000043300",
    "3000030000040300",
    "0003030000040300",
    "0000030300040300",
    "0000030303040000",
    "0000030303400000",
    "0000030330400000"
  ]
}
