{
  "puzzle_info": {
    "grid_width": 4,
    "grid_height": 4,
    "steps_to_solve": 12
  },
  "solution_path": [
    "0440030000003000",
    "0400030000003040",
    "0400030000003400",
    "0400000003003400",
    "0000040003003400",
    "3000040003000400",
    "0003040003000400",
    "0000040003000403",
    "0000000403000403",
    "0000000403030400",
    "0000000403300400",
    "0300000400300400",
    "0300040400300000"
  ]
}
