{
  "puzzle_info": {
    "grid_width": 4,
    "grid_height": 4,
    "steps_to_solve": 12
  },
  "solution_path": [
    "0000032042000000",
    "0000302042000000",
    "0000302002004000",
    "0200302000004000",
    "0200032000004000",
    "0200030000004020",
    "0200030000000420",
    "0200030004000020",
    "0200000304000020",
    "0000020304000020",
    "0000023004000020",
    "0000203004000020",
    "0000203004000002"
  ]
}
