{
  "puzzle_info": {
    "grid_width": 4,
    "grid_height": 4,
    "steps_to_solve": 13
  },
  "solution_path": [
    "0203000000030004",
    "0230000000030004",
    "2030000000030004",
    "2030000000034000",
    "0030000020034000",
    "0030000000234000",
    "0000003000234000",
    "0000003000034020",
    "0000003030004020",
    "0000003030000420",
    "0400003030000020",
    "0400003030200000",
    "0400003003200000",
    "0400003003020000"
  ]
}
