{
  "puzzle_info": {
    "grid_width": 4,
    "grid_height": 4,
    "steps_to_solve": 12
  },
  "solution_path": [
    "0200302000004000",
    "0200002030004000",
    "0200002030000004",
    "0000002030000204",
    "0000002030000240",
    "0000000030200240",
    "0200000030200040",
    "0200000003200040",
    "0200000003020040",
    "0240000003020000",
    "0240000003200000",
    "0200004003200000",
    "0200004003020000"
  ]
}
