{
  "puzzle_info": {
    "grid_width": 4,
    "grid_height": 4,
    "steps_to_solve": 14
  },
  "solution_path": [
    "2200003000000030",
    "0200003000002030",
    "2000003000002030",
    "2000003000002300",
    "2000203000000300",
    "0002203000000300",
    "0000203000000302",
    "0000230000000302",
    "0000230000000320",
    "0000230003000020",
    "0300200003000020",
    "0300000203000020",
    "0000030203000020",
    "0000032003000020",
    "0300002003000020"
  ]
}
