{
  "puzzle_info": {
    "grid_width": 4,
    "grid_height": 4,
    "steps_to_solve": 13
  },
  "solution_path": [
    "0000004030200400",
    "3000004000200400",
    "3000004020000400",
    "3000204000000400",
    "0003204000000400",
    "0000204000000403",
    "0000024000000403",
    "0000020400000403",
    "0000020000040403",
    "0000020000040430",
    "0000020004040030",
    "0030020004040000",
    "0030020004400000",
    "0030020040400000"
  ]
}
