{
  "puzzle_info": {
    "grid_width": 4,
    "grid_height": 4,
    "steps_to_solve": 13
  },
  "solution_path": [
    "0000020403000004",
    "0200000403000004",
    "0200030400000004",
    "0200003400000004",
    "0000003400000204",
    "0000003000040204",
    "0000003040000204",
    "0000003040000024",
    "0000003040200004",
    "0004003040200000",
    "4000003040200000",
    "0000403040200000",
    "0000043040200000",
    "0000040340200000"
  ]
}
