{
  "puzzle_info": {
    "grid_width": 4,
    "grid_height": 4,
    "steps_to_solve": 16
  },
  "solution_path": [
    "0000004003300020",
    "0000004030300020",
    "0000004033000020",
    "0000000033400020",
    "0000000033040020",
    "0000000030340020",
    "0030000030040020",
    "0030002030040000",
    "0030002000340000",
    "0030002000040030",
    "0030002040000030",
    "0030000040200030",
    "0000003040200030",
    "0000003004200030",
    "0000003004020030",
    "0000003004320000",
    "0030000004320000"
  ]
}
