{
  "puzzle_info": {
    "grid_width": 4,
    "grid_height": 4,
    "steps_to_solve": 11
  },
  "solution_path": [
    "0000220000000320",
    "0200200000000320",
    "0200000200000320",
    "0200030200000020",
    "0200003200000020",
    "0000003200000220",
    "0000003000000222",
    "0000003000200202",
    "0000003020000202",
    "0000003020000220",
    "0000003020200200",
    "0030000020200200"
  ]
}
