{
  "puzzle_info": {
    "grid_width": 4,
    "grid_height": 4,
    "steps_to_solve": 12
  },
  "solution_path": [
    "4030030000000004",
    "4300030000000004",
    "4300000000000304",
    "4000000003000304",
    "4004000003000300",
    "4400000003000300",
    "4000040003000300",
    "0004040003000300",
    "0004040000030300",
    "0000040400030300",
    "0000040403030000",
    "0000040403300000",
    "0000040430300000"
  ]
}
