{
  "puzzle_info": {
    "grid_width": 4,
    "grid_height": 4,
    "steps_to_solve": 13
  },
  "solution_path": [
    "3000000000002032",
    "3030000000002002",
    "0330000000002002",
    "0330000000000022",
    "0300000000300022",
    "0302000000300020",
    "0320000000300020",
    "3020000000300020",
    "3000002000300020",
    "3000002030000020",
    "0000302030000020",
    "0000302030200000",
    "0000302003200000",
    "0000302003020000"
  ]
}
