{
  "puzzle_info": {
    "grid_width": 4,
    "grid_height": 4,
    "steps_to_solve": 12
  },
  "solution_path": [
    "4200000002000400",
    "0200000002004400",
    "0000020002004400",
    "0000020000024400",
    "0000020004024000",
    "0000200004024000",
    "0000200004204000",
    "0400200000204000",
    "0400200040200000",
    "0400000240200000",
    "0400000204200000",
    "0000040204200000",
    "0000040200200400"
  ]
}
