{
  "puzzle_info": {
    "grid_width": 4,
    "grid_height": 4,
    "steps_to_solve": 13
  },
  "solution_path": [
    "2440000000030000",
    "2040000000030400",
    "2400000000030400",
    "2000000004030400",
    "0002000004030400",
    "0002000000430400",
    "0002000300400400",
    "0002300000400400",
    "0402300000400000",
    "0420300000400000",
    "0020300000400400",
    "0000302000400400",
    "0000032000400400",
    "0020030000400400"
  ]
}
