{
  "puzzle_info": {
    "grid_width": 4,
    "grid_height": 4,
    "steps_to_solve": 11
  },
  "solution_path": [
    "2000000020300002",
    "0002000020300002",
    "0002000023000002",
    "2002000003000002",
    "2002000203000000",
    "2200000203000000",
    "0200000203002000",
    "0000020203002000",
    "0000020203000002",
    "0000020203020000",
    "0000020203200000",
    "0000020200200300"
  ]
}
