{
  "puzzle_info": {
    "grid_width": 4,
    "grid_height": 4,
    "steps_to_solve": 12
  },
  "solution_path": [
    "0230000004000004",
    "0230000000000404",
    "0230000000000044",
    "0200000000300044",
    "0204000000300040",
    "0024000000300040",
    "0004002000300040",
    "4000002000300040",
    "4000002030000040",
    "0000402030000040",
    "0000402030400000",
    "0000402003400000",
    "0000402003040000"
  ]
}
