{
  "puzzle_info": {
    "grid_width": 4,
    "grid_height": 4,
    "steps_to_solve": 12
  },
  "solution_path": [
    "0200000200000023",
    "0000000200000223",
    "0020000200000203",
    "0020000200000230",
    "0020000000000232",
    "0020003000000202",
    "0020003000000220",
    "0020003000200200",
    "0020300000200200",
    "0000302000200200",
    "0000032000200200",
    "0000032002200000",
    "0300002002200000"
  ]
}
