{
  "puzzle_info": {
    "grid_width": 4,
    "grid_height": 4,
    "steps_to_solve": 12
  },
  "solution_path": [
    "4000002004004000",
    "4000002000044000",
    "4000402000040000",
    "0004402000040000",
    "0000402400040000",
    "0000420400040000",
    "0000424000040000",
    "0000404000040200",
    "0000044000040200",
    "0000044000000204",
    "0000044000000240",
    "0000044002000040",
    "0000404002000040"
  ]
}
