{
  "puzzle_info": {
    "grid_width": 4,
    "grid_height": 4,
    "steps_to_solve": 12
  },
  "solution_path": [
    "4000220200000000",
    "4000020200002000",
    "4000200200002000",
    "4000000220002000",
    "0000400220002000",
    "0000004220002000",
    "0000004020002002",
    "0000004020000022",
    "0000004020200002",
    "0000004002200002",
    "0000004002000022",
    "0002004002000020",
    "2000004002000020"
  ]
}
