{
  "puzzle_info": {
    "grid_width": 4,
    "grid_height": 4,
    "steps_to_solve": 14
  },
  "solution_path": [
    "0000000300024040",
    "0003000000024040",
    "0003000200004040",
    "0003200000004040",
    "0003200040000040",
    "0003200040000004",
    "0000200040030004",
    "0000200000430004",
    "0000200000434000",
    "0000200040430000",
    "0000200004430000",
    "0040200004030000",
    "0040200004300000",
    "0000204004300000",
    "0000204004030000"
  ]
}
